id,time,款,項,目,節,科目名稱,人事費,業務費_經,奬補助費_經,債務費,預備金_經,經常支出小計,業務費_資,設備及投資,奬補助費_資,預備金_資,資本支出小計,合計
201,105,1,,,,總統府主管,695969,363425,3093,0,2073,1064560,0,50279,0,0,50279,1114839
201,105,,1,,,總統府,695969,363425,3093,0,2073,1064560,0,50279,0,0,50279,1114839
201,105,,,,,國務支出,695969,363425,3093,0,2073,1064560,0,50279,0,0,50279,1114839
201,105,,,1,,一般行政,687394,235324,3093,0,0,925811,0,50279,0,0,50279,976090
201,105,,,2,,國務機要,0,30000,0,0,0,30000,0,0,0,0,0,30000
201,105,,,3,,國家慶典,500,51112,0,0,0,51612,0,0,0,0,0,51612
201,105,,,4,,研究發展,0,8569,0,0,0,8569,0,0,0,0,0,8569
201,105,,,,1,國家發展研究及諮詢,0,8569,0,0,0,8569,0,0,0,0,0,8569
201,105,,,5,,新聞發布,0,11417,0,0,0,11417,0,0,0,0,0,11417
201,105,,,6,,卸任禮遇,8075,19246,0,0,0,27321,0,0,0,0,0,27321
201,105,,,7,,公報編印及印信勳章鑄造,0,7757,0,0,0,7757,0,0,0,0,0,7757
201,105,,,8,,第一預備金,0,0,0,0,2073,2073,0,0,0,0,0,2073
201,106,1,,,,總統府主管,00020000000,,,,,,,,,,,,
201,106,,1,,,總統府,00020010000,642915,288085,1067,0,2073,934140,0,19335,0,0,19335,953475
201,106,,,,,國務支出,32020010000,642915,288085,1067,0,2073,934140,0,19335,0,0,19335,953475
201,106,,,1,,一般行政,32020010100,634510,191948,1067,0,0,827525,0,19335,0,0,19335,846860
201,106,,,2,,國務機要,32020010200,0,30000,0,0,0,30000,0,0,0,0,0,30000
201,106,,,3,,國家慶典,32020010300,0,16575,0,0,0,16575,0,0,0,0,0,16575
201,106,,,4,,研究發展,32020010400,0,12126,0,0,0,12126,0,0,0,0,0,12126
201,106,,,,1,國家發展研究及諮詢,32020010401,0,12126,0,0,0,12126,0,0,0,0,0,12126
201,106,,,5,,新聞發布,32020010500,0,11366,0,0,0,11366,0,0,0,0,0,11366
201,106,,,6,,卸任禮遇,32020010600,8405,16850,0,0,0,25255,0,0,0,0,0,25255
201,106,,,7,,公報編印及印信勳章鑄造,32020010800,0,9220,0,0,0,9220,0,0,0,0,0,9220
201,106,,,8,,第一預備金,32020019800,0,0,0,0,2073,2073,0,0,0,0,0,2073
201,107,1,,,,總統府主管,00020000000,623763,271587,977,0,2373,898700,0,21882,0,0,21882,920582
201,107,,1,,,總統府,00020010000,623763,271587,977,0,2373,898700,0,21882,0,0,21882,920582
201,107,,,,,國務支出,32020010000,623763,271587,977,0,2373,898700,0,21882,0,0,21882,920582
201,107,,,1,,一般行政,32020010100,615358,188166,977,0,0,804501,0,21882,0,0,21882,826383
201,107,,,2,,國務機要,32020010200,0,30000,0,0,0,30000,0,0,0,0,0,30000
201,107,,,3,,國家慶典,32020010300,0,15614,0,0,0,15614,0,0,0,0,0,15614
201,107,,,4,,研究發展,32020010400,0,6861,0,0,0,6861,0,0,0,0,0,6861
201,107,,,,1,國家發展研究及諮詢,32020010401,0,6861,0,0,0,6861,0,0,0,0,0,6861
201,107,,,5,,新聞發布,32020010500,0,10194,0,0,0,10194,0,0,0,0,0,10194
201,107,,,6,,卸任禮遇,32020010600,8405,15350,0,0,0,23755,0,0,0,0,0,23755
201,107,,,7,,公報編印及印信勳章鑄造,32020010800,0,5402,0,0,0,5402,0,0,0,0,0,5402
201,107,,,8,,第一預備金,32020019800,0,0,0,0,2373,2373,0,0,0,0,0,2373
201,108,1,,,,總統府主管,00020000000,636510,290707,966,0,2873,931056,0,42411,0,0,42411,973467
201,108,,1,,,總統府,00020010000,636510,290707,966,0,2873,931056,0,42411,0,0,42411,973467
201,108,,,,,國務支出,32020010000,636510,290707,966,0,2873,931056,0,42411,0,0,42411,973467
201,108,,,1,,一般行政,32020010100,627852,210234,966,0,0,839052,0,42411,0,0,42411,881463
201,108,,,2,,國務機要,32020010200,0,30000,0,0,0,30000,0,0,0,0,0,30000
201,108,,,3,,國家慶典,32020010300,0,15805,0,0,0,15805,0,0,0,0,0,15805
201,108,,,4,,研究發展,32020010400,0,6724,0,0,0,6724,0,0,0,0,0,6724
201,108,,,,1,國家發展研究及諮詢,32020010401,0,6724,0,0,0,6724,0,0,0,0,0,6724
201,108,,,5,,新聞發布,32020010500,0,7353,0,0,0,7353,0,0,0,0,0,7353
201,108,,,6,,卸任禮遇,32020010600,8658,13850,0,0,0,22508,0,0,0,0,0,22508
201,108,,,7,,公報編印及印信勳章鑄造,32020010800,0,6741,0,0,0,6741,0,0,0,0,0,6741
201,108,,,8,,第一預備金,32020019800,0,0,0,0,2873,2873,0,0,0,0,0,2873
201,109,1,,,,總統府主管,00020000000,,,,,,,,,,,,
201,109,,1,,,總統府,00020010000,636119,321005,966,0,3072,961162,0,43169,0,0,43169,1004331
201,109,,,,,國務支出,31020010000,636119,321005,966,0,3072,961162,0,43169,0,0,43169,1004331
201,109,,,1,,一般行政,31020010100,627852,204631,966,0,0,833449,0,43169,0,0,43169,876618
201,109,,,2,,國務機要,31020010200,0,30000,0,0,0,30000,0,0,0,0,0,30000
201,109,,,3,,國家慶典,31020010300,500,50641,0,0,0,51141,0,0,0,0,0,51141
201,109,,,4,,研究發展,31020010400,0,8195,0,0,0,8195,0,0,0,0,0,8195
201,109,,,,1,國家發展研究及諮詢,31020010401,0,8195,0,0,0,8195,0,0,0,0,0,8195
201,109,,,5,,新聞發布,31020010500,0,7335,0,0,0,7335,0,0,0,0,0,7335
201,109,,,6,,卸任禮遇,31020010600,7767,14200,0,0,0,21967,0,0,0,0,0,21967
201,109,,,7,,公報編印及印信勳章鑄造,31020010800,0,6003,0,0,0,6003,0,0,0,0,0,6003
201,109,,,8,,第一預備金,31020019800,0,0,0,0,3072,3072,0,0,0,0,0,3072
201,110,1,,,,總統府主管,00020000000,,,,,,,,,,,,
201,110,,1,,,總統府,00020010000,633344,294187,911,0,3372,931814,0,47102,0,0,47102,978916
201,110,,,,,國務支出,31020010000,633344,294187,911,0,3372,931814,0,47102,0,0,47102,978916
201,110,,,1,,一般行政,31020010100,630161,226435,911,0,0,857507,0,38827,0,0,38827,896334
201,110,,,2,,國務機要,31020010200,0,30000,0,0,0,30000,0,0,0,0,0,30000
201,110,,,3,,國家慶典,31020010300,0,15760,0,0,0,15760,0,0,0,0,0,15760
201,110,,,4,,研究發展,31020010400,0,5332,0,0,0,5332,0,0,0,0,0,5332
201,110,,,,1,國家發展研究及諮詢,31020010401,0,5332,0,0,0,5332,0,0,0,0,0,5332
201,110,,,5,,新聞發布,31020010500,0,6799,0,0,0,6799,0,0,0,0,0,6799
201,110,,,6,,卸任禮遇,31020010600,3183,5500,0,0,0,8683,0,0,0,0,0,8683
201,110,,,7,,公報編印及印信勳章鑄造,31020010800,0,4361,0,0,0,4361,0,0,0,0,0,4361
201,110,,,8,,一般建築及設備,31020019000,0,0,0,0,0,0,0,8275,0,0,8275,8275
201,110,,,,1,交通及運輸設備,31020019011,0,0,0,0,0,0,0,8275,0,0,8275,8275
201,110,,,9,,第一預備金,31020019800,0,0,0,0,3372,3372,0,0,0,0,0,3372
201,111,1,,,,總統府主管,00020000000,,,,,,,,,,,,
201,111,,1,,,總統府,00020010000,635653,300301,911,0,3372,940237,0,52733,0,0,52733,992970
201,111,,,,,國務支出,31020010000,635653,300301,911,0,3372,940237,0,52733,0,0,52733,992970
201,111,,,1,,一般行政,31020010100,632470,232993,911,0,0,866374,0,42713,0,0,42713,909087
201,111,,,2,,國務機要,31020010200,0,30000,0,0,0,30000,0,0,0,0,0,30000
201,111,,,3,,國家慶典,31020010300,0,15662,0,0,0,15662,0,0,0,0,0,15662
201,111,,,4,,研究發展,31020010400,0,5142,0,0,0,5142,0,0,0,0,0,5142
201,111,,,,1,國家發展研究及諮詢,31020010401,0,5142,0,0,0,5142,0,0,0,0,0,5142
201,111,,,5,,新聞發布,31020010500,0,6699,0,0,0,6699,0,0,0,0,0,6699
201,111,,,6,,卸任禮遇,31020010600,3183,5500,0,0,0,8683,0,0,0,0,0,8683
201,111,,,7,,公報編印及印信勳章鑄造,31020010800,0,4305,0,0,0,4305,0,0,0,0,0,4305
201,111,,,8,,一般建築及設備,31020019000,0,0,0,0,0,0,0,10020,0,0,10020,10020
201,111,,,,1,交通及運輸設備,31020019011,0,0,0,0,0,0,0,10020,0,0,10020,10020
201,111,,,9,,第一預備金,31020019800,0,0,0,0,3372,3372,0,0,0,0,0,3372
201,112,1,,,,總統府主管,00020000000,,,,,,,,,,,,
201,112,,1,,,總統府,00020010000,660785,301873,911,0,3372,966941,0,71648,0,0,71648,1038589
201,112,,,,,國務支出,31020010000,660785,301873,911,0,3372,966941,0,71648,0,0,71648,1038589
201,112,,,1,,一般行政,31020010100,657474,235223,911,0,0,893608,0,61853,0,0,61853,955461
201,112,,,2,,國務機要,31020010200,0,30000,0,0,0,30000,0,0,0,0,0,30000
201,112,,,3,,國家慶典,31020010300,0,15568,0,0,0,15568,0,0,0,0,0,15568
201,112,,,4,,研究發展,31020010400,0,5001,0,0,0,5001,0,0,0,0,0,5001
201,112,,,,1,國家發展研究及諮詢,31020010401,0,5001,0,0,0,5001,0,0,0,0,0,5001
201,112,,,5,,新聞發布,31020010500,0,6684,0,0,0,6684,0,0,0,0,0,6684
201,112,,,6,,卸任禮遇,31020010600,3311,5500,0,0,0,8811,0,0,0,0,0,8811
201,112,,,7,,公報編印及印信勳章鑄造,31020010800,0,3897,0,0,0,3897,0,0,0,0,0,3897
201,112,,,8,,一般建築及設備,31020019000,0,0,0,0,0,0,0,9795,0,0,9795,9795
201,112,,,,1,交通及運輸設備,31020019011,0,0,0,0,0,0,0,9795,0,0,9795,9795
201,112,,,9,,第一預備金,31020019800,0,0,0,0,3372,3372,0,0,0,0,0,3372
201,105,1,,,,總統府主管,697285,372004,3094,0,2073,1074456,0,52925,0,0,52925,1127381
201,105,,1,,,總統府,697285,372004,3094,0,2073,1074456,0,52925,0,0,52925,1127381
201,105,,,,,國務支出,697285,372004,3094,0,2073,1074456,0,52925,0,0,52925,1127381
201,105,,,1,,一般行政,688710,238867,3094,0,0,930671,0,52925,0,0,52925,983596
201,105,,,2,,國務機要,0,30000,0,0,0,30000,0,0,0,0,0,30000
201,105,,,3,,國家慶典,500,56112,0,0,0,56612,0,0,0,0,0,56612
201,105,,,4,,研究發展,0,8605,0,0,0,8605,0,0,0,0,0,8605
201,105,,,,1,國家發展研究及諮詢,0,8605,0,0,0,8605,0,0,0,0,0,8605
201,105,,,5,,新聞發布,0,11417,0,0,0,11417,0,0,0,0,0,11417
201,105,,,6,,卸任禮遇,8075,19246,0,0,0,27321,0,0,0,0,0,27321
201,105,,,7,,公報編印及印信勳章鑄造,0,7757,0,0,0,7757,0,0,0,0,0,7757
201,105,,,8,,第一預備金,0,0,0,0,2073,2073,0,0,0,0,0,2073
201,106,1,,,,總統府主管,642915,292187,2924,0,2073,940099,0,27535,0,0,27535,967634
201,106,,1,,,總統府,642915,292187,2924,0,2073,940099,0,27535,0,0,27535,967634
201,106,,,,,國務支出,642915,292187,2924,0,2073,940099,0,27535,0,0,27535,967634
201,106,,,1,,一般行政,634510,195050,2924,0,0,832484,0,19335,0,0,19335,851819
201,106,,,2,,國務機要,0,30000,0,0,0,30000,0,0,0,0,0,30000
201,106,,,3,,國家慶典,0,17075,0,0,0,17075,0,0,0,0,0,17075
201,106,,,4,,研究發展,0,12626,0,0,0,12626,0,0,0,0,0,12626
201,106,,,,1,國家發展研究及諮詢,0,12626,0,0,0,12626,0,0,0,0,0,12626
201,106,,,5,,新聞發布,0,11366,0,0,0,11366,0,0,0,0,0,11366
201,106,,,6,,卸任禮遇,8405,16850,0,0,0,25255,0,0,0,0,0,25255
201,106,,,7,,公報編印及印信勳章鑄造,0,9220,0,0,0,9220,0,0,0,0,0,9220
201,106,,,8,,一般建築及設備,0,0,0,0,0,0,0,8200,0,0,8200,8200
201,106,,,,1,交通及運輸設備,0,0,0,0,0,0,0,8200,0,0,8200,8200
201,106,,,9,,第一預備金,0,0,0,0,2073,2073,0,0,0,0,0,2073
201,107,1,,,,總統府主管,00020000000,623763,272707,978,0,2373,899821,0,24099,0,0,24099,923920
201,107,,1,,,總統府,00020010000,623763,272707,978,0,2373,899821,0,24099,0,0,24099,923920
201,107,,,,,國務支出,32020010000,623763,272707,978,0,2373,899821,0,24099,0,0,24099,923920
201,107,,,1,,一般行政,32020010100,615358,188386,978,0,0,804722,0,24099,0,0,24099,828821
201,107,,,2,,國務機要,32020010200,0,30000,0,0,0,30000,0,0,0,0,0,30000
201,107,,,3,,國家慶典,32020010300,0,15614,0,0,0,15614,0,0,0,0,0,15614
201,107,,,4,,研究發展,32020010400,0,7611,0,0,0,7611,0,0,0,0,0,7611
201,107,,,,1,國家發展研究及諮詢,32020010401,0,7611,0,0,0,7611,0,0,0,0,0,7611
201,107,,,5,,新聞發布,32020010500,0,10344,0,0,0,10344,0,0,0,0,0,10344
201,107,,,6,,卸任禮遇,32020010600,8405,15350,0,0,0,23755,0,0,0,0,0,23755
201,107,,,7,,公報編印及印信勳章鑄造,32020010800,0,5402,0,0,0,5402,0,0,0,0,0,5402
201,107,,,8,,第一預備金,32020019800,0,0,0,0,2373,2373,0,0,0,0,0,2373
201,108,1,,,,總統府主管,00020000000,636510,294492,968,0,2873,934843,0,44643,0,0,44643,979486
201,108,,1,,,總統府,00020010000,636510,294492,968,0,2873,934843,0,44643,0,0,44643,979486
201,108,,,,,國務支出,32020010000,636510,294492,968,0,2873,934843,0,44643,0,0,44643,979486
201,108,,,1,,一般行政,32020010100,627852,213700,968,0,0,842520,0,44643,0,0,44643,887163
201,108,,,2,,國務機要,32020010200,0,30000,0,0,0,30000,0,0,0,0,0,30000
201,108,,,3,,國家慶典,32020010300,0,16105,0,0,0,16105,0,0,0,0,0,16105
201,108,,,4,,研究發展,32020010400,0,6743,0,0,0,6743,0,0,0,0,0,6743
201,108,,,,1,國家發展研究及諮詢,32020010401,0,6743,0,0,0,6743,0,0,0,0,0,6743
201,108,,,5,,新聞發布,32020010500,0,7353,0,0,0,7353,0,0,0,0,0,7353
201,108,,,6,,卸任禮遇,32020010600,8658,13850,0,0,0,22508,0,0,0,0,0,22508
201,108,,,7,,公報編印及印信勳章鑄造,32020010800,0,6741,0,0,0,6741,0,0,0,0,0,6741
201,108,,,8,,第一預備金,32020019800,0,0,0,0,2873,2873,0,0,0,0,0,2873
201,109,1,,,,總統府主管,00020000000,,,,,,,,,,,,
201,109,,1,,,總統府,00020010000,636119,324855,968,0,3072,965014,0,45924,0,0,45924,1010938
201,109,,,,,國務支出,31020010000,636119,324855,968,0,3072,965014,0,45924,0,0,45924,1010938
201,109,,,1,,一般行政,31020010100,627852,208462,968,0,0,837282,0,45924,0,0,45924,883206
201,109,,,2,,國務機要,31020010200,0,30000,0,0,0,30000,0,0,0,0,0,30000
201,109,,,3,,國家慶典,31020010300,500,50641,0,0,0,51141,0,0,0,0,0,51141
201,109,,,4,,研究發展,31020010400,0,8214,0,0,0,8214,0,0,0,0,0,8214
201,109,,,,1,國家發展研究及諮詢,31020010401,0,8214,0,0,0,8214,0,0,0,0,0,8214
201,109,,,5,,新聞發布,31020010500,0,7335,0,0,0,7335,0,0,0,0,0,7335
201,109,,,6,,卸任禮遇,31020010600,7767,14200,0,0,0,21967,0,0,0,0,0,21967
201,109,,,7,,公報編印及印信勳章鑄造,31020010800,0,6003,0,0,0,6003,0,0,0,0,0,6003
201,109,,,8,,第一預備金,31020019800,0,0,0,0,3072,3072,0,0,0,0,0,3072
201,110,1,,,,總統府主管,00020000000,,,,,,,,,,,,
201,110,,1,,,總統府,00020010000,633344,302377,914,0,3372,940007,0,50108,0,0,50108,990115
201,110,,,,,國務支出,31020010000,633344,302377,914,0,3372,940007,0,50108,0,0,50108,990115
201,110,,,1,,一般行政,31020010100,630161,233887,914,0,0,864962,0,41833,0,0,41833,906795
201,110,,,2,,國務機要,31020010200,0,30000,0,0,0,30000,0,0,0,0,0,30000
201,110,,,3,,國家慶典,31020010300,0,15775,0,0,0,15775,0,0,0,0,0,15775
201,110,,,4,,研究發展,31020010400,0,5536,0,0,0,5536,0,0,0,0,0,5536
201,110,,,,1,國家發展研究及諮詢,31020010401,0,5536,0,0,0,5536,0,0,0,0,0,5536
201,110,,,5,,新聞發布,31020010500,0,7318,0,0,0,7318,0,0,0,0,0,7318
201,110,,,6,,卸任禮遇,31020010600,3183,5500,0,0,0,8683,0,0,0,0,0,8683
201,110,,,7,,公報編印及印信勳章鑄造,31020010800,0,4361,0,0,0,4361,0,0,0,0,0,4361
201,110,,,8,,一般建築及設備,31020019000,0,0,0,0,0,0,0,8275,0,0,8275,8275
201,110,,,,1,交通及運輸設備,31020019011,0,0,0,0,0,0,0,8275,0,0,8275,8275
201,110,,,9,,第一預備金,31020019800,0,0,0,0,3372,3372,0,0,0,0,0,3372
201,111,1,,,,總統府主管,00020000000,,,,,,,,,,,,
201,111,,1,,,總統府,00020010000,635653,308759,914,0,3372,948698,0,56099,0,0,56099,1004797
201,111,,,,,國務支出,31020010000,635653,308759,914,0,3372,948698,0,56099,0,0,56099,1004797
201,111,,,1,,一般行政,31020010100,632470,241063,914,0,0,874447,0,46079,0,0,46079,920526
201,111,,,2,,國務機要,31020010200,0,30000,0,0,0,30000,0,0,0,0,0,30000
201,111,,,3,,國家慶典,31020010300,0,15760,0,0,0,15760,0,0,0,0,0,15760
201,111,,,4,,研究發展,31020010400,0,5332,0,0,0,5332,0,0,0,0,0,5332
201,111,,,,1,國家發展研究及諮詢,31020010401,0,5332,0,0,0,5332,0,0,0,0,0,5332
201,111,,,5,,新聞發布,31020010500,0,6799,0,0,0,6799,0,0,0,0,0,6799
201,111,,,6,,卸任禮遇,31020010600,3183,5500,0,0,0,8683,0,0,0,0,0,8683
201,111,,,7,,公報編印及印信勳章鑄造,31020010800,0,4305,0,0,0,4305,0,0,0,0,0,4305
201,111,,,8,,一般建築及設備,31020019000,0,0,0,0,0,0,0,10020,0,0,10020,10020
201,111,,,,1,交通及運輸設備,31020019011,0,0,0,0,0,0,0,10020,0,0,10020,10020
201,111,,,9,,第一預備金,31020019800,0,0,0,0,3372,3372,0,0,0,0,0,3372
201,112,1,,,,總統府主管,00020000000,,,,,,,,,,,,
201,112,,1,,,總統府,00020010000,660785,309810,914,0,3372,974881,0,76221,0,0,76221,1051102
201,112,,,,,國務支出,31020010000,660785,309810,914,0,3372,974881,0,76221,0,0,76221,1051102
201,112,,,1,,一般行政,31020010100,657474,242543,914,0,0,900931,0,65801,0,0,65801,966732
201,112,,,2,,國務機要,31020010200,0,30000,0,0,0,30000,0,0,0,0,0,30000
201,112,,,3,,國家慶典,31020010300,0,15662,0,0,0,15662,0,0,0,0,0,15662
201,112,,,4,,研究發展,31020010400,0,5101,0,0,0,5101,0,0,0,0,0,5101
201,112,,,,1,國家發展研究及諮詢,31020010401,0,5101,0,0,0,5101,0,0,0,0,0,5101
201,112,,,5,,新聞發布,31020010500,0,6699,0,0,0,6699,0,0,0,0,0,6699
201,112,,,6,,卸任禮遇,31020010600,3311,5500,0,0,0,8811,0,0,0,0,0,8811
201,112,,,7,,公報編印及印信勳章鑄造,31020010800,0,4305,0,0,0,4305,0,0,0,0,0,4305
201,112,,,8,,一般建築及設備,31020019000,0,0,0,0,0,0,0,10420,0,0,10420,10420
201,112,,,,1,交通及運輸設備,31020019011,0,0,0,0,0,0,0,10420,0,0,10420,10420
201,112,,,9,,第一預備金,31020019800,0,0,0,0,3372,3372,0,0,0,0,0,3372
201,113,1,,,,總統府主管,00020000000,,,,,,,,,,,,
201,113,,1,,,總統府,00020010000,661285,406465,914,0,3372,1072036,0,78169,0,0,78169,1150205
201,113,,,,,國務支出,31020010000,661285,406465,914,0,3372,1072036,0,78169,0,0,78169,1150205
201,113,,,1,,一般行政,31020010100,657474,292010,914,0,0,950398,0,67879,0,0,67879,1018277
201,113,,,2,,國務機要,31020010200,0,30000,0,0,0,30000,0,0,0,0,0,30000
201,113,,,3,,國家慶典,31020010300,500,56882,0,0,0,57382,0,0,0,0,0,57382
201,113,,,4,,研究發展,31020010400,0,5042,0,0,0,5042,0,0,0,0,0,5042
201,113,,,,1,國家發展研究及諮詢,31020010401,0,5042,0,0,0,5042,0,0,0,0,0,5042
201,113,,,5,,新聞發布,31020010500,0,8184,0,0,0,8184,0,0,0,0,0,8184
201,113,,,6,,卸任禮遇,31020010600,3311,8500,0,0,0,11811,0,0,0,0,0,11811
201,113,,,7,,公報編印及印信勳章鑄造,31020010800,0,5847,0,0,0,5847,0,0,0,0,0,5847
201,113,,,8,,一般建築及設備,31020019000,0,0,0,0,0,0,0,10290,0,0,10290,10290
201,113,,,,1,交通及運輸設備,31020019011,0,0,0,0,0,0,0,10290,0,0,10290,10290
201,113,,,9,,第一預備金,31020019800,0,0,0,0,3372,3372,0,0,0,0,0,3372
240,105,1,,,,總統府主管,2661797,5702881,1387509,0,8194,9760381,0,5629686,0,0,5629686,15390067
240,105,,5,,,中央研究院,2661797,5702881,1387509,0,8194,9760381,0,5629686,0,0,5629686,15390067
240,105,,,,,科學支出,2661797,5702881,1387509,0,8194,9760381,0,5629686,0,0,5629686,15390067
240,105,,,1,,一般行政,196972,168515,2340,0,0,367827,0,6925,0,0,6925,374752
240,105,,,2,,一般學術研究及評議,2464825,1937834,1195927,0,0,5598586,0,456878,0,0,456878,6055464
240,105,,,,1,學術審議及研究獎助,2464825,357179,112514,0,0,2934518,0,151264,0,0,151264,3085782
240,105,,,,2,主題研究與人才培育,0,1580655,1083413,0,0,2664068,0,305614,0,0,305614,2969682
240,105,,,3,,自然及人文社會科學研究,0,3596532,131031,0,0,3727563,0,876595,0,0,876595,4604158
240,105,,,,1,數理科學研究,0,1322322,35958,0,0,1358280,0,391332,0,0,391332,1749612
240,105,,,,2,生命科學研究,0,1534676,70021,0,0,1604697,0,301177,0,0,301177,1905874
240,105,,,,3,人文及社會科學研究,0,739534,25052,0,0,764586,0,184086,0,0,184086,948672
240,105,,,4,,國家生技研究園區,0,0,58211,0,0,58211,0,3936903,0,0,3936903,3995114
240,105,,,5,,一般建築及設備,0,0,0,0,0,0,0,352385,0,0,352385,352385
240,105,,,,1,土地購置,0,0,0,0,0,0,0,88000,0,0,88000,88000
240,105,,,,2,營建工程,0,0,0,0,0,0,0,263960,0,0,263960,263960
240,105,,,,3,交通及運輸設備,0,0,0,0,0,0,0,425,0,0,425,425
240,105,,,6,,第一預備金,0,0,0,0,8194,8194,0,0,0,0,0,8194
240,106,1,,,,總統府主管,00020000000,2593414,5600139,1670754,0,7375,9871682,0,4042879,0,0,4042879,13914561
240,106,,5,,,中央研究院,00020400000,2593414,5600139,1670754,0,7375,9871682,0,4042879,0,0,4042879,13914561
240,106,,,,,科學支出,52020400000,2593414,5600139,1670754,0,7375,9871682,0,4042879,0,0,4042879,13914561
240,106,,,1,,一般行政,52020400100,196508,165900,366,0,0,362774,0,1000,0,0,1000,363774
240,106,,,2,,一般學術研究及評議,52020401000,2396906,1910308,1542864,0,0,5850078,0,422753,0,0,422753,6272831
240,106,,,,1,學術審議及研究獎助,52020401020,2396906,357812,113568,0,0,2868286,0,139315,0,0,139315,3007601
240,106,,,,2,主題研究與人才培育,52020401023,0,1552496,1429296,0,0,2981792,0,283438,0,0,283438,3265230
240,106,,,3,,自然及人文社會科學研究,52020402000,0,3523931,127524,0,0,3651455,0,813865,0,0,813865,4465320
240,106,,,,1,數理科學研究,52020402010,0,1289616,33650,0,0,1323266,0,360451,0,0,360451,1683717
240,106,,,,2,生命科學研究,52020402020,0,1507432,67814,0,0,1575246,0,279721,0,0,279721,1854967
240,106,,,,3,人文及社會科學研究,52020402030,0,726883,26060,0,0,752943,0,173693,0,0,173693,926636
240,106,,,4,,國家生技研究園區,52020403000,0,0,0,0,0,0,0,1171455,0,0,1171455,1171455
240,106,,,5,,一般建築及設備,52020409000,0,0,0,0,0,0,0,1633806,0,0,1633806,1633806
240,106,,,,1,土地購置,52020409001,0,0,0,0,0,0,0,1458200,0,0,1458200,1458200
240,106,,,,2,營建工程,52020409002,0,0,0,0,0,0,0,175606,0,0,175606,175606
240,106,,,6,,第一預備金,52020409800,0,0,0,0,7375,7375,0,0,0,0,0,7375
240,107,1,,,,總統府主管,00020000000,2502488,5681377,1735543,0,7375,9926783,0,2205107,0,0,2205107,12131890
240,107,,5,,,中央研究院,00020400000,2502488,5681377,1735543,0,7375,9926783,0,2205107,0,0,2205107,12131890
240,107,,,,,科學支出,52020400000,2502488,5681377,1735543,0,7375,9926783,0,2205107,0,0,2205107,12131890
240,107,,,1,,一般行政,52020400100,195408,65794,414,0,0,261616,0,1020,0,0,1020,262636
240,107,,,2,,一般學術研究及評議,52020401000,2307080,2205470,1399933,0,0,5912483,0,688451,0,0,688451,6600934
240,107,,,,1,學術審議及研究獎助,52020401020,2307080,603602,93669,0,0,3004351,0,318916,0,0,318916,3323267
240,107,,,,2,主題研究與人才培育,52020401023,0,1601868,1306264,0,0,2908132,0,369535,0,0,369535,3277667
240,107,,,3,,自然及人文社會科學研究,52020402000,0,3410113,124503,0,0,3534616,0,817148,0,0,817148,4351764
240,107,,,,1,數理科學研究,52020402010,0,1233486,31974,0,0,1265460,0,367294,0,0,367294,1632754
240,107,,,,2,生命科學研究,52020402020,0,1457677,65364,0,0,1523041,0,265805,0,0,265805,1788846
240,107,,,,3,人文及社會科學研究,52020402030,0,718950,27165,0,0,746115,0,184049,0,0,184049,930164
240,107,,,4,,國家生技研究園區,52020403000,0,0,210693,0,0,210693,0,448634,0,0,448634,659327
240,107,,,5,,南部院區,52020404000,0,0,0,0,0,0,0,246014,0,0,246014,246014
240,107,,,6,,一般建築及設備,52020409000,0,0,0,0,0,0,0,3840,0,0,3840,3840
240,107,,,,3,交通及運輸設備,52020409011,0,0,0,0,0,0,0,3840,0,0,3840,3840
240,107,,,7,,第一預備金,52020409800,0,0,0,0,7375,7375,0,0,0,0,0,7375
240,108,1,,,,總統府主管,00020000000,2622981,6002149,1281936,0,7375,9914441,0,2532438,0,0,2532438,12446879
240,108,,5,,,中央研究院,00020400000,2622981,6002149,1281936,0,7375,9914441,0,2532438,0,0,2532438,12446879
240,108,,,,,科學支出,52020400000,2622981,6002149,1281936,0,7375,9914441,0,2532438,0,0,2532438,12446879
240,108,,,1,,一般行政,52020400100,206515,62840,414,0,0,269769,0,811,0,0,811,270580
240,108,,,2,,一般學術研究及評議,52020401000,2416466,2431132,366568,0,0,5214166,0,384502,0,0,384502,5598668
240,108,,,,1,學術審議及研究獎助,52020401020,2416466,650645,95953,0,0,3163064,0,156305,0,0,156305,3319369
240,108,,,,2,主題研究與人才培育,52020401023,0,1780487,270615,0,0,2051102,0,228197,0,0,228197,2279299
240,108,,,3,,自然及人文社會科學研究,52020402000,0,3508177,130148,0,0,3638325,0,808078,0,0,808078,4446403
240,108,,,,1,數理科學研究,52020402010,0,1268507,37996,0,0,1306503,0,370022,0,0,370022,1676525
240,108,,,,2,生命科學研究,52020402020,0,1505735,65672,0,0,1571407,0,273397,0,0,273397,1844804
240,108,,,,3,人文及社會科學研究,52020402030,0,733935,26480,0,0,760415,0,164659,0,0,164659,925074
240,108,,,4,,南部院區,52020404000,0,0,0,0,0,0,0,1090450,0,0,1090450,1090450
240,108,,,5,,非營業特種基金,52020405000,0,0,784806,0,0,784806,0,248597,0,0,248597,1033403
240,108,,,,1,科學研究基金,52020405010,0,0,784806,0,0,784806,0,248597,0,0,248597,1033403
240,108,,,7,,第一預備金,52020409800,0,0,0,0,7375,7375,0,0,0,0,0,7375
240,109,1,,,,總統府主管,00020000000,,,,,,,,,,,,
240,109,,5,,,中央研究院,00020400000,2650017,6082787,1437886,0,7375,10178065,0,2367934,0,0,2367934,12545999
240,109,,,,,科學支出,52020400000,2650017,6082787,1437886,0,7375,10178065,0,2367934,0,0,2367934,12545999
240,109,,,1,,一般行政,52020400100,206515,56623,432,0,0,263570,0,896,0,0,896,264466
240,109,,,2,,一般學術研究及評議,52020401000,2443502,2565188,383407,0,0,5392097,0,490065,0,0,490065,5882162
240,109,,,,1,學術審議及研究獎助,52020401020,2443502,777147,103252,0,0,3323901,0,260001,0,0,260001,3583902
240,109,,,,2,主題研究與人才培育,52020401023,0,1788041,280155,0,0,2068196,0,230064,0,0,230064,2298260
240,109,,,3,,自然及人文社會科學研究,52020402000,0,3447923,125569,0,0,3573492,0,746603,0,0,746603,4320095
240,109,,,,1,數理科學研究,52020402010,0,1222979,37964,0,0,1260943,0,338784,0,0,338784,1599727
240,109,,,,2,生命科學研究,52020402020,0,1495887,61479,0,0,1557366,0,257890,0,0,257890,1815256
240,109,,,,3,人文及社會科學研究,52020402030,0,729057,26126,0,0,755183,0,149929,0,0,149929,905112
240,109,,,4,,南部院區,52020404000,0,13053,0,0,0,13053,0,1033783,0,0,1033783,1046836
240,109,,,5,,非營業特種基金,52020405000,0,0,928478,0,0,928478,0,93679,0,0,93679,1022157
240,109,,,,1,科學研究基金,52020405010,0,0,928478,0,0,928478,0,93679,0,0,93679,1022157
240,109,,,6,,一般建築及設備,52020409000,0,0,0,0,0,0,0,2908,0,0,2908,2908
240,109,,,,1,交通及運輸設備,52020409011,0,0,0,0,0,0,0,2908,0,0,2908,2908
240,109,,,7,,第一預備金,52020409800,0,0,0,0,7375,7375,0,0,0,0,0,7375
240,110,1,,,,總統府主管,00020000000,,,,,,,,,,,,
240,110,,5,,,中央研究院,00020400000,2667953,6287433,1524643,0,7375,10487404,0,2122306,0,0,2122306,12609710
240,110,,,,,科學支出,52020400000,2667953,6287433,1524643,0,7375,10487404,0,2122306,0,0,2122306,12609710
240,110,,,1,,一般行政,52020400100,210588,50284,432,0,0,261304,0,1694,0,0,1694,262998
240,110,,,2,,一般學術研究及評議,52020401000,2457365,2717496,386206,0,0,5561067,0,539590,0,0,539590,6100657
240,110,,,3,,自然及人文社會科學研究,52020402000,0,3413371,125126,0,0,3538497,0,819257,0,0,819257,4357754
240,110,,,,1,數理科學研究,52020402010,0,1177986,36964,0,0,1214950,0,330352,0,0,330352,1545302
240,110,,,,2,生命科學研究,52020402020,0,1528711,62500,0,0,1591211,0,317728,0,0,317728,1908939
240,110,,,,3,人文及社會科學研究,52020402030,0,706674,25662,0,0,732336,0,171177,0,0,171177,903513
240,110,,,4,,南部院區,52020404000,0,106282,2000,0,0,108282,0,719478,0,0,719478,827760
240,110,,,5,,非營業特種基金,52020405000,0,0,1010879,0,0,1010879,0,40407,0,0,40407,1051286
240,110,,,,1,科學研究基金,52020405010,0,0,1010879,0,0,1010879,0,40407,0,0,40407,1051286
240,110,,,6,,一般建築及設備,52020409000,0,0,0,0,0,0,0,1880,0,0,1880,1880
240,110,,,,1,交通及運輸設備,52020409011,0,0,0,0,0,0,0,1880,0,0,1880,1880
240,110,,,7,,第一預備金,52020409800,0,0,0,0,7375,7375,0,0,0,0,0,7375
240,111,1,,,,總統府主管,00020000000,,,,,,,,,,,,
240,111,,5,,,中央研究院,00020400000,2713070,6236233,1388002,0,7375,10344680,0,2580083,0,0,2580083,12924763
240,111,,,,,科學支出,52020400000,2713070,6236233,1388002,0,7375,10344680,0,2580083,0,0,2580083,12924763
240,111,,,1,,一般行政,52020400100,212743,47237,432,0,0,260412,0,1534,0,0,1534,261946
240,111,,,2,,一般學術研究及評議,52020401000,2500327,2763727,373898,0,0,5637952,0,697067,0,0,697067,6335019
240,111,,,,1,人力資源,52020401010,2500327,0,65000,0,0,2565327,0,0,0,0,0,2565327
240,111,,,,2,學術研究與人才培育,52020401020,0,2763727,308898,0,0,3072625,0,697067,0,0,697067,3769692
240,111,,,3,,自然及人文社會科學研究,52020402000,0,3310224,130962,0,0,3441186,0,703535,0,0,703535,4144721
240,111,,,,1,數理科學研究,52020402010,0,1162193,41372,0,0,1203565,0,289710,0,0,289710,1493275
240,111,,,,2,生命科學研究,52020402020,0,1461444,64550,0,0,1525994,0,256255,0,0,256255,1782249
240,111,,,,3,人文及社會科學研究,52020402030,0,686587,25040,0,0,711627,0,157570,0,0,157570,869197
240,111,,,4,,南部院區,52020404000,0,115045,1000,0,0,116045,0,766002,0,0,766002,882047
240,111,,,5,,非營業特種基金,52020405000,0,0,881710,0,0,881710,0,406685,0,0,406685,1288395
240,111,,,,1,科學研究基金,52020405010,0,0,881710,0,0,881710,0,406685,0,0,406685,1288395
240,111,,,6,,一般建築及設備,52020409000,0,0,0,0,0,0,0,5260,0,0,5260,5260
240,111,,,,1,交通及運輸設備,52020409011,0,0,0,0,0,0,0,5260,0,0,5260,5260
240,111,,,7,,第一預備金,52020409800,0,0,0,0,7375,7375,0,0,0,0,0,7375
240,112,1,,,,總統府主管,00020000000,,,,,,,,,,,,
240,112,,5,,,中央研究院,00020400000,2802125,6341197,1488839,0,7375,10639536,0,2598496,0,0,2598496,13238032
240,112,,,,,科學支出,52020400000,2802125,6341197,1488839,0,7375,10639536,0,2598496,0,0,2598496,13238032
240,112,,,1,,一般行政,52020400100,221724,48727,432,0,0,270883,0,1806,0,0,1806,272689
240,112,,,2,,一般學術研究及評議,52020401000,2580401,2683827,371699,0,0,5635927,0,639691,0,0,639691,6275618
240,112,,,,1,人力資源,52020401010,2580401,0,60000,0,0,2640401,0,0,0,0,0,2640401
240,112,,,,2,學術研究與人才培育,52020401020,0,2683827,311699,0,0,2995526,0,639691,0,0,639691,3635217
240,112,,,3,,自然及人文社會科學研究,52020402000,0,3456284,135902,0,0,3592186,0,772561,0,0,772561,4364747
240,112,,,,1,數理科學研究,52020402010,0,1211386,44254,0,0,1255640,0,312872,0,0,312872,1568512
240,112,,,,2,生命科學研究,52020402020,0,1522532,67000,0,0,1589532,0,295272,0,0,295272,1884804
240,112,,,,3,人文及社會科學研究,52020402030,0,722366,24648,0,0,747014,0,164417,0,0,164417,911431
240,112,,,4,,南部院區,52020404000,0,152359,3500,0,0,155859,0,702547,0,0,702547,858406
240,112,,,5,,非營業特種基金,52020405000,0,0,977306,0,0,977306,0,478351,0,0,478351,1455657
240,112,,,,1,科學研究基金,52020405010,0,0,977306,0,0,977306,0,478351,0,0,478351,1455657
240,112,,,6,,一般建築及設備,52020409000,0,0,0,0,0,0,0,3540,0,0,3540,3540
240,112,,,,1,交通及運輸設備,52020409011,0,0,0,0,0,0,0,3540,0,0,3540,3540
240,112,,,7,,第一預備金,52020409800,0,0,0,0,7375,7375,0,0,0,0,0,7375
240,105,1,,,,總統府主管,2666838,5703445,1387509,0,8194,9765986,0,5640446,0,0,5640446,15406432
240,105,,5,,,中央研究院,2666838,5703445,1387509,0,8194,9765986,0,5640446,0,0,5640446,15406432
240,105,,,,,科學支出,2666838,5703445,1387509,0,8194,9765986,0,5640446,0,0,5640446,15406432
240,105,,,1,,一般行政,197500,168519,2340,0,0,368359,0,6925,0,0,6925,375284
240,105,,,2,,一般學術研究及評議,2469338,1938000,1195927,0,0,5603265,0,456878,0,0,456878,6060143
240,105,,,,1,學術審議及研究獎助,2469338,357204,112514,0,0,2939056,0,151264,0,0,151264,3090320
240,105,,,,2,主題研究與人才培育,0,1580796,1083413,0,0,2664209,0,305614,0,0,305614,2969823
240,105,,,3,,自然及人文社會科學研究,0,3596926,131031,0,0,3727957,0,876595,0,0,876595,4604552
240,105,,,,1,數理科學研究,0,1322482,35958,0,0,1358440,0,391332,0,0,391332,1749772
240,105,,,,2,生命科學研究,0,1534747,70021,0,0,1604768,0,301177,0,0,301177,1905945
240,105,,,,3,人文及社會科學研究,0,739697,25052,0,0,764749,0,184086,0,0,184086,948835
240,105,,,4,,國家生技研究園區,0,0,58211,0,0,58211,0,3936903,0,0,3936903,3995114
240,105,,,5,,一般建築及設備,0,0,0,0,0,0,0,363145,0,0,363145,363145
240,105,,,,1,土地購置,0,0,0,0,0,0,0,88000,0,0,88000,88000
240,105,,,,2,營建工程,0,0,0,0,0,0,0,274720,0,0,274720,274720
240,105,,,,3,交通及運輸設備,0,0,0,0,0,0,0,425,0,0,425,425
240,105,,,6,,第一預備金,0,0,0,0,8194,8194,0,0,0,0,0,8194
240,106,1,,,,總統府主管,2593414,5628675,1672828,0,7375,9902292,0,4269144,0,0,4269144,14171436
240,106,,5,,,中央研究院,2593414,5628675,1672828,0,7375,9902292,0,4269144,0,0,4269144,14171436
240,106,,,,,科學支出,2593414,5628675,1672828,0,7375,9902292,0,4269144,0,0,4269144,14171436
240,106,,,1,,一般行政,196508,166630,2430,0,0,365568,0,1000,0,0,1000,366568
240,106,,,2,,一般學術研究及評議,2396906,1918321,1542874,0,0,5858101,0,422753,0,0,422753,6280854
240,106,,,,1,學術審議及研究獎助,2396906,360256,113578,0,0,2870740,0,139315,0,0,139315,3010055
240,106,,,,2,主題研究與人才培育,0,1558065,1429296,0,0,2987361,0,283438,0,0,283438,3270799
240,106,,,3,,自然及人文社會科學研究,0,3543724,127524,0,0,3671248,0,813865,0,0,813865,4485113
240,106,,,,1,數理科學研究,0,1297212,33650,0,0,1330862,0,360451,0,0,360451,1691313
240,106,,,,2,生命科學研究,0,1515091,67814,0,0,1582905,0,279721,0,0,279721,1862626
240,106,,,,3,人文及社會科學研究,0,731421,26060,0,0,757481,0,173693,0,0,173693,931174
240,106,,,4,,國家生技研究園區,0,0,0,0,0,0,0,1397720,0,0,1397720,1397720
240,106,,,5,,一般建築及設備,0,0,0,0,0,0,0,1633806,0,0,1633806,1633806
240,106,,,,1,土地購置,0,0,0,0,0,0,0,1458200,0,0,1458200,1458200
240,106,,,,2,營建工程,0,0,0,0,0,0,0,175606,0,0,175606,175606
240,106,,,6,,第一預備金,0,0,0,0,7375,7375,0,0,0,0,0,7375
240,107,1,,,,總統府主管,00020000000,2502488,5698995,1735549,0,7375,9944407,0,2428532,0,0,2428532,12372939
240,107,,5,,,中央研究院,00020400000,2502488,5698995,1735549,0,7375,9944407,0,2428532,0,0,2428532,12372939
240,107,,,,,科學支出,52020400000,2502488,5698995,1735549,0,7375,9944407,0,2428532,0,0,2428532,12372939
240,107,,,1,,一般行政,52020400100,195408,65795,414,0,0,261617,0,1020,0,0,1020,262637
240,107,,,2,,一般學術研究及評議,52020401000,2307080,2212207,1399939,0,0,5919226,0,688451,0,0,688451,6607677
240,107,,,,1,學術審議及研究獎助,52020401020,2307080,604722,93675,0,0,3005477,0,318916,0,0,318916,3324393
240,107,,,,2,主題研究與人才培育,52020401023,0,1607485,1306264,0,0,2913749,0,369535,0,0,369535,3283284
240,107,,,3,,自然及人文社會科學研究,52020402000,0,3420993,124503,0,0,3545496,0,817148,0,0,817148,4362644
240,107,,,,1,數理科學研究,52020402010,0,1237891,31974,0,0,1269865,0,367294,0,0,367294,1637159
240,107,,,,2,生命科學研究,52020402020,0,1461079,65364,0,0,1526443,0,265805,0,0,265805,1792248
240,107,,,,3,人文及社會科學研究,52020402030,0,722023,27165,0,0,749188,0,184049,0,0,184049,933237
240,107,,,4,,國家生技研究園區,52020403000,0,0,210693,0,0,210693,0,560346,0,0,560346,771039
240,107,,,5,,南部院區,52020404000,0,0,0,0,0,0,0,357727,0,0,357727,357727
240,107,,,6,,一般建築及設備,52020409000,0,0,0,0,0,0,0,3840,0,0,3840,3840
240,107,,,,3,交通及運輸設備,52020409011,0,0,0,0,0,0,0,3840,0,0,3840,3840
240,107,,,7,,第一預備金,52020409800,0,0,0,0,7375,7375,0,0,0,0,0,7375
240,108,1,,,,總統府主管,00020000000,2622981,6032714,1281943,0,7375,9945013,0,2665724,0,0,2665724,12610737
240,108,,5,,,中央研究院,00020400000,2622981,6032714,1281943,0,7375,9945013,0,2665724,0,0,2665724,12610737
240,108,,,,,科學支出,52020400000,2622981,6032714,1281943,0,7375,9945013,0,2665724,0,0,2665724,12610737
240,108,,,1,,一般行政,52020400100,206515,63798,414,0,0,270727,0,853,0,0,853,271580
240,108,,,2,,一般學術研究及評議,52020401000,2416466,2441938,366575,0,0,5224979,0,388534,0,0,388534,5613513
240,108,,,,1,學術審議及研究獎助,52020401020,2416466,654749,95960,0,0,3167175,0,157194,0,0,157194,3324369
240,108,,,,2,主題研究與人才培育,52020401023,0,1787189,270615,0,0,2057804,0,231340,0,0,231340,2289144
240,108,,,3,,自然及人文社會科學研究,52020402000,0,3526978,130148,0,0,3657126,0,838656,0,0,838656,4495782
240,108,,,,1,數理科學研究,52020402010,0,1275402,37996,0,0,1313398,0,384023,0,0,384023,1697421
240,108,,,,2,生命科學研究,52020402020,0,1513159,65672,0,0,1578831,0,283743,0,0,283743,1862574
240,108,,,,3,人文及社會科學研究,52020402030,0,738417,26480,0,0,764897,0,170890,0,0,170890,935787
240,108,,,4,,南部院區,52020404000,0,0,0,0,0,0,0,1176000,0,0,1176000,1176000
240,108,,,5,,非營業特種基金,52020405000,0,0,784806,0,0,784806,0,261681,0,0,261681,1046487
240,108,,,,1,科學研究基金,52020405010,0,0,784806,0,0,784806,0,261681,0,0,261681,1046487
240,108,,,7,,第一預備金,52020409800,0,0,0,0,7375,7375,0,0,0,0,0,7375
240,109,1,,,,總統府主管,00020000000,,,,,,,,,,,,
240,109,,5,,,中央研究院,00020400000,2650017,6116707,1437894,0,7375,10211993,0,2519079,0,0,2519079,12731072
240,109,,,,,科學支出,52020400000,2650017,6116707,1437894,0,7375,10211993,0,2519079,0,0,2519079,12731072
240,109,,,1,,一般行政,52020400100,206515,56914,432,0,0,263861,0,896,0,0,896,264757
240,109,,,2,,一般學術研究及評議,52020401000,2443502,2577134,383415,0,0,5404051,0,490065,0,0,490065,5894116
240,109,,,,1,學術審議及研究獎助,52020401020,2443502,780691,103260,0,0,3327453,0,260001,0,0,260001,3587454
240,109,,,,2,主題研究與人才培育,52020401023,0,1796443,280155,0,0,2076598,0,230064,0,0,230064,2306662
240,109,,,3,,自然及人文社會科學研究,52020402000,0,3469481,125569,0,0,3595050,0,794259,0,0,794259,4389309
240,109,,,,1,數理科學研究,52020402010,0,1230914,37964,0,0,1268878,0,360409,0,0,360409,1629287
240,109,,,,2,生命科學研究,52020402020,0,1504449,61479,0,0,1565928,0,274351,0,0,274351,1840279
240,109,,,,3,人文及社會科學研究,52020402030,0,734118,26126,0,0,760244,0,159499,0,0,159499,919743
240,109,,,4,,南部院區,52020404000,0,13178,0,0,0,13178,0,1137272,0,0,1137272,1150450
240,109,,,5,,非營業特種基金,52020405000,0,0,928478,0,0,928478,0,93679,0,0,93679,1022157
240,109,,,,1,科學研究基金,52020405010,0,0,928478,0,0,928478,0,93679,0,0,93679,1022157
240,109,,,6,,一般建築及設備,52020409000,0,0,0,0,0,0,0,2908,0,0,2908,2908
240,109,,,,1,交通及運輸設備,52020409011,0,0,0,0,0,0,0,2908,0,0,2908,2908
240,109,,,7,,第一預備金,52020409800,0,0,0,0,7375,7375,0,0,0,0,0,7375
240,110,1,,,,總統府主管,00020000000,,,,,,,,,,,,
240,110,,5,,,中央研究院,00020400000,2667953,6364665,1524653,0,7375,10564646,0,2257772,0,0,2257772,12822418
240,110,,,,,科學支出,52020400000,2667953,6364665,1524653,0,7375,10564646,0,2257772,0,0,2257772,12822418
240,110,,,1,,一般行政,52020400100,210588,51028,432,0,0,262048,0,1802,0,0,1802,263850
240,110,,,2,,一般學術研究及評議,52020401000,2457365,2747412,386216,0,0,5590993,0,559671,0,0,559671,6150664
240,110,,,3,,自然及人文社會科學研究,52020402000,0,3458665,125126,0,0,3583791,0,886013,0,0,886013,4469804
240,110,,,,1,數理科學研究,52020402010,0,1195635,36964,0,0,1232599,0,351490,0,0,351490,1584089
240,110,,,,2,生命科學研究,52020402020,0,1547058,62500,0,0,1609558,0,352420,0,0,352420,1961978
240,110,,,,3,人文及社會科學研究,52020402030,0,715972,25662,0,0,741634,0,182103,0,0,182103,923737
240,110,,,4,,南部院區,52020404000,0,107560,2000,0,0,109560,0,765420,0,0,765420,874980
240,110,,,5,,非營業特種基金,52020405000,0,0,1010879,0,0,1010879,0,42986,0,0,42986,1053865
240,110,,,,1,科學研究基金,52020405010,0,0,1010879,0,0,1010879,0,42986,0,0,42986,1053865
240,110,,,6,,一般建築及設備,52020409000,0,0,0,0,0,0,0,1880,0,0,1880,1880
240,110,,,,1,交通及運輸設備,52020409011,0,0,0,0,0,0,0,1880,0,0,1880,1880
240,110,,,7,,第一預備金,52020409800,0,0,0,0,7375,7375,0,0,0,0,0,7375
240,111,1,,,,總統府主管,00020000000,,,,,,,,,,,,
240,111,,5,,,中央研究院,00020400000,2713070,6306773,1388012,0,7375,10415230,0,2744769,0,0,2744769,13159999
240,111,,,,,科學支出,52020400000,2713070,6306773,1388012,0,7375,10415230,0,2744769,0,0,2744769,13159999
240,111,,,1,,一般行政,52020400100,212743,48024,432,0,0,261199,0,1747,0,0,1747,262946
240,111,,,2,,一般學術研究及評議,52020401000,2500327,2793309,373908,0,0,5667544,0,697067,0,0,697067,6364611
240,111,,,,1,人力資源,52020401010,2500327,0,65000,0,0,2565327,0,0,0,0,0,2565327
240,111,,,,2,學術研究與人才培育,52020401020,0,2793309,308908,0,0,3102217,0,697067,0,0,697067,3799284
240,111,,,3,,自然及人文社會科學研究,52020402000,0,3348961,130962,0,0,3479923,0,738008,0,0,738008,4217931
240,111,,,,1,數理科學研究,52020402010,0,1177944,41372,0,0,1219316,0,303906,0,0,303906,1523222
240,111,,,,2,生命科學研究,52020402020,0,1477036,64550,0,0,1541586,0,268811,0,0,268811,1810397
240,111,,,,3,人文及社會科學研究,52020402030,0,693981,25040,0,0,719021,0,165291,0,0,165291,884312
240,111,,,4,,南部院區,52020404000,0,116479,1000,0,0,117479,0,896002,0,0,896002,1013481
240,111,,,5,,非營業特種基金,52020405000,0,0,881710,0,0,881710,0,406685,0,0,406685,1288395
240,111,,,,1,科學研究基金,52020405010,0,0,881710,0,0,881710,0,406685,0,0,406685,1288395
240,111,,,6,,一般建築及設備,52020409000,0,0,0,0,0,0,0,5260,0,0,5260,5260
240,111,,,,1,交通及運輸設備,52020409011,0,0,0,0,0,0,0,5260,0,0,5260,5260
240,111,,,7,,第一預備金,52020409800,0,0,0,0,7375,7375,0,0,0,0,0,7375
240,112,1,,,,總統府主管,00020000000,,,,,,,,,,,,
240,112,,5,,,中央研究院,00020400000,2802125,6409661,1489155,0,7375,10708316,0,2764357,0,0,2764357,13472673
240,112,,,,,科學支出,52020400000,2802125,6409661,1489155,0,7375,10708316,0,2764357,0,0,2764357,13472673
240,112,,,1,,一般行政,52020400100,221724,49399,432,0,0,271555,0,1947,0,0,1947,273502
240,112,,,2,,一般學術研究及評議,52020401000,2580401,2711290,372015,0,0,5663706,0,673933,0,0,673933,6337639
240,112,,,,1,人力資源,52020401010,2580401,0,60000,0,0,2640401,0,0,0,0,0,2640401
240,112,,,,2,學術研究與人才培育,52020401020,0,2711290,312015,0,0,3023305,0,673933,0,0,673933,3697238
240,112,,,3,,自然及人文社會科學研究,52020402000,0,3494328,135902,0,0,3630230,0,814058,0,0,814058,4444288
240,112,,,,1,數理科學研究,52020402010,0,1226324,44254,0,0,1270578,0,329716,0,0,329716,1600294
240,112,,,,2,生命科學研究,52020402020,0,1538044,67000,0,0,1605044,0,311078,0,0,311078,1916122
240,112,,,,3,人文及社會科學研究,52020402030,0,729960,24648,0,0,754608,0,173264,0,0,173264,927872
240,112,,,4,,南部院區,52020404000,0,154644,3500,0,0,158144,0,766922,0,0,766922,925066
240,112,,,5,,非營業特種基金,52020405000,0,0,977306,0,0,977306,0,503957,0,0,503957,1481263
240,112,,,,1,科學研究基金,52020405010,0,0,977306,0,0,977306,0,503957,0,0,503957,1481263
240,112,,,6,,一般建築及設備,52020409000,0,0,0,0,0,0,0,3540,0,0,3540,3540
240,112,,,,1,交通及運輸設備,52020409011,0,0,0,0,0,0,0,3540,0,0,3540,3540
240,112,,,7,,第一預備金,52020409800,0,0,0,0,7375,7375,0,0,0,0,0,7375
240,113,1,,,,總統府主管,00020000000,,,,,,,,,,,,
240,113,,5,,,中央研究院,00020400000,2797783,6711560,1503750,0,7375,11020468,0,2634519,0,0,2634519,13654987
240,113,,,,,科學支出,52020400000,2797783,6711560,1503750,0,7375,11020468,0,2634519,0,0,2634519,13654987
240,113,,,1,,一般行政,52020400100,224912,48063,432,0,0,273407,0,1790,0,0,1790,275197
240,113,,,2,,一般學術研究及評議,52020401000,2572871,2845897,569511,0,0,5988279,0,717487,0,0,717487,6705766
240,113,,,,1,人力資源,52020401010,2572871,0,70000,0,0,2642871,0,0,0,0,0,2642871
240,113,,,,2,學術研究與人才培育,52020401020,0,2845897,499511,0,0,3345408,0,717487,0,0,717487,4062895
240,113,,,3,,自然及人文社會科學研究,52020402000,0,3575994,135380,0,0,3711374,0,777938,0,0,777938,4489312
240,113,,,,1,數理科學研究,52020402010,0,1243737,47578,0,0,1291315,0,339071,0,0,339071,1630386
240,113,,,,2,生命科學研究,52020402020,0,1566903,62860,0,0,1629763,0,272092,0,0,272092,1901855
240,113,,,,3,人文及社會科學研究,52020402030,0,765354,24942,0,0,790296,0,166775,0,0,166775,957071
240,113,,,4,,南部院區,52020404000,0,241606,5000,0,0,246606,0,651117,0,0,651117,897723
240,113,,,5,,非營業特種基金,52020405000,0,0,793427,0,0,793427,0,478107,0,0,478107,1271534
240,113,,,,1,科學研究基金,52020405010,0,0,793427,0,0,793427,0,478107,0,0,478107,1271534
240,113,,,6,,一般建築及設備,52020409000,0,0,0,0,0,0,0,8080,0,0,8080,8080
240,113,,,,1,交通及運輸設備,52020409011,0,0,0,0,0,0,0,8080,0,0,8080,8080
240,113,,,7,,第一預備金,52020409800,0,0,0,0,7375,7375,0,0,0,0,0,7375
301,105,2,,,,行政院主管,857976,265825,5080,0,3800,1132681,0,144889,0,0,144889,1277570
301,105,,1,,,行政院,857976,265825,5080,0,3800,1132681,0,144889,0,0,144889,1277570
301,105,,,,,行政支出,857976,265825,5080,0,3800,1132681,0,144889,0,0,144889,1277570
301,105,,,1,,一般行政,832364,69430,1590,0,0,903384,0,2029,0,0,2029,905413
301,105,,,2,,施政及法制業務,0,12359,0,0,0,12359,0,0,0,0,0,12359
301,105,,,3,,施政推展聯繫,0,6250,0,0,0,6250,0,0,0,0,0,6250
301,105,,,4,,科技發展研究諮詢,25612,12998,0,0,0,38610,0,2011,0,0,2011,40621
301,105,,,5,,聯合服務業務,0,27323,0,0,0,27323,0,85792,0,0,85792,113115
301,105,,,6,,國土及資通安全業務,0,8573,0,0,0,8573,0,20,0,0,20,8593
301,105,,,7,,災害防救業務,0,7317,800,0,0,8117,0,0,0,0,0,8117
301,105,,,8,,性別平等業務,0,15274,200,0,0,15474,0,0,0,0,0,15474
301,105,,,9,,消保及食安業務,0,15068,2430,0,0,17498,0,1785,0,0,1785,19283
301,105,,,10,,資訊管理,0,35368,0,0,0,35368,0,34008,0,0,34008,69376
301,105,,,11,,新聞傳播業務,0,55865,60,0,0,55925,0,999,0,0,999,56924
301,105,,,12,,一般建築及設備,0,0,0,0,0,0,0,18245,0,0,18245,18245
301,105,,,,1,營建工程,0,0,0,0,0,0,0,10850,0,0,10850,10850
301,105,,,,2,交通及運輸設備,0,0,0,0,0,0,0,3680,0,0,3680,3680
301,105,,,,3,其他設備,0,0,0,0,0,0,0,3715,0,0,3715,3715
301,105,,,13,,第一預備金,0,0,0,0,3800,3800,0,0,0,0,0,3800
301,106,2,,,,行政院主管,00030000000,842108,257288,3202,0,3800,1106398,0,127664,0,0,127664,1234062
301,106,,1,,,行政院,00030010000,842108,257288,3202,0,3800,1106398,0,127664,0,0,127664,1234062
301,106,,,,,行政支出,33030010000,842108,257288,3202,0,3800,1106398,0,127664,0,0,127664,1234062
301,106,,,1,,一般行政,33030010100,816496,70159,432,0,0,887087,0,2029,0,0,2029,889116
301,106,,,2,,施政及法制業務,33030010700,0,10803,0,0,0,10803,0,0,0,0,0,10803
301,106,,,3,,施政推展聯繫,33030011100,0,6250,0,0,0,6250,0,0,0,0,0,6250
301,106,,,4,,科技發展研究諮詢,33030011500,25612,12358,0,0,0,37970,0,1011,0,0,1011,38981
301,106,,,5,,聯合服務業務,33030011600,0,27193,0,0,0,27193,0,81422,0,0,81422,108615
301,106,,,6,,國土及資通安全業務,33030011800,0,8533,0,0,0,8533,0,60,0,0,60,8593
301,106,,,7,,災害防救業務,33030011900,0,7317,760,0,0,8077,0,0,0,0,0,8077
301,106,,,8,,性別平等業務,33030012000,0,15031,0,0,0,15031,0,0,0,0,0,15031
301,106,,,9,,消保及食安業務,33030012200,0,15241,1950,0,0,17191,0,90,0,0,90,17281
301,106,,,10,,資訊管理,33030012300,0,28538,0,0,0,28538,0,31692,0,0,31692,60230
301,106,,,11,,新聞傳播業務,33030012400,0,55865,60,0,0,55925,0,999,0,0,999,56924
301,106,,,12,,一般建築及設備,33030019000,0,0,0,0,0,0,0,10361,0,0,10361,10361
301,106,,,,1,營建工程,33030019002,0,0,0,0,0,0,0,6466,0,0,6466,6466
301,106,,,,2,交通及運輸設備,33030019011,0,0,0,0,0,0,0,180,0,0,180,180
301,106,,,,3,其他設備,33030019019,0,0,0,0,0,0,0,3715,0,0,3715,3715
301,106,,,13,,第一預備金,33030019800,0,0,0,0,3800,3800,0,0,0,0,0,3800
301,107,2,,,,行政院主管,00030000000,836630,248404,3081,0,3800,1091915,0,207024,0,0,207024,1298939
301,107,,1,,,行政院,00030010000,836630,248404,3081,0,3800,1091915,0,207024,0,0,207024,1298939
301,107,,,,,行政支出,33030010000,836630,248404,3081,0,3800,1091915,0,207024,0,0,207024,1298939
301,107,,,1,,一般行政,33030010100,811146,69595,432,0,0,881173,0,2029,0,0,2029,883202
301,107,,,2,,施政及法制業務,33030010700,0,11245,0,0,0,11245,0,0,0,0,0,11245
301,107,,,3,,施政推展聯繫,33030011100,0,6150,0,0,0,6150,0,0,0,0,0,6150
301,107,,,4,,科技發展研究諮詢,33030011500,25484,11448,0,0,0,36932,0,3361,0,0,3361,40293
301,107,,,5,,聯合服務業務,33030011600,0,26765,0,0,0,26765,0,149782,0,0,149782,176547
301,107,,,6,,國土及資通安全業務,33030011800,0,7968,0,0,0,7968,0,60,0,0,60,8028
301,107,,,7,,災害防救業務,33030011900,0,6940,715,0,0,7655,0,0,0,0,0,7655
301,107,,,8,,性別平等業務,33030012000,0,14298,0,0,0,14298,0,0,0,0,0,14298
301,107,,,9,,消保及食安業務,33030012200,0,13388,1894,0,0,15282,0,90,0,0,90,15372
301,107,,,10,,資訊管理,33030012300,0,28836,0,0,0,28836,0,32092,0,0,32092,60928
301,107,,,11,,新聞傳播業務,33030012400,0,51771,40,0,0,51811,0,1609,0,0,1609,53420
301,107,,,12,,一般建築及設備,33030019000,0,0,0,0,0,0,0,18001,0,0,18001,18001
301,107,,,,1,營建工程,33030019002,0,0,0,0,0,0,0,12266,0,0,12266,12266
301,107,,,,2,交通及運輸設備,33030019011,0,0,0,0,0,0,0,2020,0,0,2020,2020
301,107,,,,3,其他設備,33030019019,0,0,0,0,0,0,0,3715,0,0,3715,3715
301,107,,,13,,第一預備金,33030019800,0,0,0,0,3800,3800,0,0,0,0,0,3800
301,108,2,,,,行政院主管,00030000000,878042,267557,3020,0,3800,1152419,0,70189,0,0,70189,1222608
301,108,,1,,,行政院,00030010000,878042,267557,3020,0,3800,1152419,0,70189,0,0,70189,1222608
301,108,,,,,行政支出,33030010000,878042,267557,3020,0,3800,1152419,0,70189,0,0,70189,1222608
301,108,,,1,,一般行政,33030010100,852558,71882,450,0,0,924890,0,2409,0,0,2409,927299
301,108,,,2,,施政及法制業務,33030010700,0,12064,0,0,0,12064,0,0,0,0,0,12064
301,108,,,3,,施政推展聯繫,33030011100,0,6150,0,0,0,6150,0,0,0,0,0,6150
301,108,,,4,,科技發展研究諮詢,33030011500,25484,12509,0,0,0,37993,0,1800,0,0,1800,39793
301,108,,,5,,聯合服務業務,33030011600,0,33624,0,0,0,33624,0,766,0,0,766,34390
301,108,,,6,,國土及資通安全業務,33030011800,0,7959,0,0,0,7959,0,60,0,0,60,8019
301,108,,,7,,災害防救業務,33030011900,0,6650,672,0,0,7322,0,300,0,0,300,7622
301,108,,,8,,性別平等業務,33030012000,0,18685,0,0,0,18685,0,0,0,0,0,18685
301,108,,,9,,消保及食安業務,33030012200,0,13061,1858,0,0,14919,0,0,0,0,0,14919
301,108,,,10,,資訊管理,33030012300,0,34592,0,0,0,34592,0,35458,0,0,35458,70050
301,108,,,11,,新聞傳播業務,33030012400,0,50381,40,0,0,50421,0,1609,0,0,1609,52030
301,108,,,12,,一般建築及設備,33030019000,0,0,0,0,0,0,0,27787,0,0,27787,27787
301,108,,,,1,營建工程,33030019002,0,0,0,0,0,0,0,22042,0,0,22042,22042
301,108,,,,2,交通及運輸設備,33030019011,0,0,0,0,0,0,0,2030,0,0,2030,2030
301,108,,,,3,其他設備,33030019019,0,0,0,0,0,0,0,3715,0,0,3715,3715
301,108,,,13,,第一預備金,33030019800,0,0,0,0,3800,3800,0,0,0,0,0,3800
301,109,2,,,,行政院主管,00030000000,,,,,,,,,,,,
301,109,,1,,,行政院,00030010000,885696,262167,2959,0,3800,1154622,0,136021,0,0,136021,1290643
301,109,,,,,行政支出,32030010000,885696,262167,2959,0,3800,1154622,0,136021,0,0,136021,1290643
301,109,,,1,,一般行政,32030010100,860212,73513,450,0,0,934175,0,2909,0,0,2909,937084
301,109,,,2,,施政及法制業務,32030010700,0,12228,0,0,0,12228,0,0,0,0,0,12228
301,109,,,3,,施政推展聯繫,32030011100,0,6150,0,0,0,6150,0,0,0,0,0,6150
301,109,,,4,,科技發展研究諮詢,32030011500,25484,12509,0,0,0,37993,0,1800,0,0,1800,39793
301,109,,,5,,聯合服務業務,32030011600,0,33709,0,0,0,33709,0,606,0,0,606,34315
301,109,,,6,,國土及資通安全業務,32030011800,0,7959,0,0,0,7959,0,60,0,0,60,8019
301,109,,,7,,災害防救業務,32030011900,0,7150,645,0,0,7795,0,100,0,0,100,7895
301,109,,,8,,性別平等業務,32030012000,0,17852,0,0,0,17852,0,0,0,0,0,17852
301,109,,,9,,消保及食安業務,32030012200,0,12284,1824,0,0,14108,0,0,0,0,0,14108
301,109,,,10,,資訊管理,32030012300,0,31892,0,0,0,31892,0,32374,0,0,32374,64266
301,109,,,11,,新聞傳播業務,32030012400,0,46921,40,0,0,46961,0,1619,0,0,1619,48580
301,109,,,12,,一般建築及設備,32030019000,0,0,0,0,0,0,0,96553,0,0,96553,96553
301,109,,,,1,營建工程,32030019002,0,0,0,0,0,0,0,87888,0,0,87888,87888
301,109,,,,2,交通及運輸設備,32030019011,0,0,0,0,0,0,0,4950,0,0,4950,4950
301,109,,,,3,其他設備,32030019019,0,0,0,0,0,0,0,3715,0,0,3715,3715
301,109,,,13,,第一預備金,32030019800,0,0,0,0,3800,3800,0,0,0,0,0,3800
301,110,2,,,,行政院主管,00030000000,,,,,,,,,,,,
301,110,,1,,,行政院,00030010000,893345,251879,2882,0,3800,1151906,0,134740,0,0,134740,1286646
301,110,,,,,行政支出,32030010000,893345,251879,2882,0,3800,1151906,0,134740,0,0,134740,1286646
301,110,,,1,,一般行政,32030010100,868361,72513,450,0,0,941324,0,2909,0,0,2909,944233
301,110,,,2,,施政及法制業務,32030010700,0,12228,0,0,0,12228,0,0,0,0,0,12228
301,110,,,3,,施政推展聯繫,32030011100,0,6150,0,0,0,6150,0,0,0,0,0,6150
301,110,,,4,,科技發展研究諮詢,32030011500,24984,12209,0,0,0,37193,0,2100,0,0,2100,39293
301,110,,,5,,聯合服務業務,32030011600,0,33604,0,0,0,33604,0,626,0,0,626,34230
301,110,,,6,,國土及資通安全業務,32030011800,0,7739,0,0,0,7739,0,80,0,0,80,7819
301,110,,,7,,災害防救業務,32030011900,0,7544,609,0,0,8153,0,60,0,0,60,8213
301,110,,,8,,性別平等業務,32030012000,0,14028,0,0,0,14028,0,0,0,0,0,14028
301,110,,,9,,消保及食安業務,32030012200,0,11530,1783,0,0,13313,0,0,0,0,0,13313
301,110,,,10,,資訊管理,32030012300,0,31524,0,0,0,31524,0,21560,0,0,21560,53084
301,110,,,11,,新聞傳播業務,32030012400,0,42810,40,0,0,42850,0,1619,0,0,1619,44469
301,110,,,12,,一般建築及設備,32030019000,0,0,0,0,0,0,0,105786,0,0,105786,105786
301,110,,,,1,營建工程,32030019002,0,0,0,0,0,0,0,96891,0,0,96891,96891
301,110,,,,2,交通及運輸設備,32030019011,0,0,0,0,0,0,0,5180,0,0,5180,5180
301,110,,,,3,其他設備,32030019019,0,0,0,0,0,0,0,3715,0,0,3715,3715
301,110,,,13,,第一預備金,32030019800,0,0,0,0,3800,3800,0,0,0,0,0,3800
301,111,2,,,,行政院主管,00030000000,,,,,,,,,,,,
301,111,,1,,,行政院,00030010000,906278,267675,2882,0,3800,1180635,0,59914,0,0,59914,1240549
301,111,,,,,行政支出,32030010000,906278,267675,2882,0,3800,1180635,0,59914,0,0,59914,1240549
301,111,,,1,,一般行政,32030010100,880794,72433,450,0,0,953677,0,2909,0,0,2909,956586
301,111,,,2,,施政及法制業務,32030010700,0,11700,0,0,0,11700,0,0,0,0,0,11700
301,111,,,3,,施政推展聯繫,32030011100,0,6150,0,0,0,6150,0,0,0,0,0,6150
301,111,,,4,,科技發展研究諮詢,32030011500,25484,10062,0,0,0,35546,0,1786,0,0,1786,37332
301,111,,,5,,聯合服務業務,32030011600,0,31760,0,0,0,31760,0,635,0,0,635,32395
301,111,,,6,,國土及資通安全業務,32030011800,0,7462,0,0,0,7462,0,85,0,0,85,7547
301,111,,,7,,災害防救業務,32030011900,0,9385,522,0,0,9907,0,19,0,0,19,9926
301,111,,,8,,性別平等業務,32030012000,0,19303,0,0,0,19303,0,0,0,0,0,19303
301,111,,,9,,消保及食安業務,32030012200,0,10357,1870,0,0,12227,0,38,0,0,38,12265
301,111,,,10,,資訊管理,32030012300,0,31024,0,0,0,31024,0,19380,0,0,19380,50404
301,111,,,11,,新聞傳播業務,32030012400,0,37250,40,0,0,37290,0,1898,0,0,1898,39188
301,111,,,12,,數位發展部籌備工作,32030012700,0,20789,0,0,0,20789,0,18879,0,0,18879,39668
301,111,,,13,,一般建築及設備,32030019000,0,0,0,0,0,0,0,14285,0,0,14285,14285
301,111,,,,1,營建工程,32030019002,0,0,0,0,0,0,0,7133,0,0,7133,7133
301,111,,,,2,交通及運輸設備,32030019011,0,0,0,0,0,0,0,3490,0,0,3490,3490
301,111,,,,3,其他設備,32030019019,0,0,0,0,0,0,0,3662,0,0,3662,3662
301,111,,,14,,第一預備金,32030019800,0,0,0,0,3800,3800,0,0,0,0,0,3800
301,112,2,,,,行政院主管,00030000000,,,,,,,,,,,,
301,112,,1,,,行政院,00030010000,978415,251111,2920,0,3800,1236246,0,73607,0,0,73607,1309853
301,112,,,,,行政支出,32030010000,978415,251111,2920,0,3800,1236246,0,73607,0,0,73607,1309853
301,112,,,1,,一般行政,32030010100,978415,78176,450,0,0,1057041,0,3029,0,0,3029,1060070
301,112,,,2,,施政及法制業務,32030010700,0,11903,0,0,0,11903,0,0,0,0,0,11903
301,112,,,3,,施政推展聯繫,32030011100,0,6150,0,0,0,6150,0,0,0,0,0,6150
301,112,,,4,,聯合服務業務,32030011600,0,30741,0,0,0,30741,0,623,0,0,623,31364
301,112,,,5,,災害防救及國土安全,32030011900,0,17262,496,0,0,17758,0,55,0,0,55,17813
301,112,,,6,,性別平等業務,32030012000,0,16293,0,0,0,16293,0,0,0,0,0,16293
301,112,,,7,,消保及食安業務,32030012200,0,9860,1954,0,0,11814,0,0,0,0,0,11814
301,112,,,8,,資訊管理,32030012300,0,31834,0,0,0,31834,0,24548,0,0,24548,56382
301,112,,,9,,新聞傳播業務,32030012400,0,35299,20,0,0,35319,0,901,0,0,901,36220
301,112,,,11,,人權及轉型正義,32030012800,0,13593,0,0,0,13593,0,0,0,0,0,13593
301,112,,,12,,一般建築及設備,32030019000,0,0,0,0,0,0,0,44451,0,0,44451,44451
301,112,,,,1,營建工程,32030019002,0,0,0,0,0,0,0,36919,0,0,36919,36919
301,112,,,,2,交通及運輸設備,32030019011,0,0,0,0,0,0,0,3540,0,0,3540,3540
301,112,,,,3,其他設備,32030019019,0,0,0,0,0,0,0,3992,0,0,3992,3992
301,112,,,13,,第一預備金,32030019800,0,0,0,0,3800,3800,0,0,0,0,0,3800
301,105,2,,,,行政院主管,865603,265833,5080,0,3800,1140316,0,146889,0,0,146889,1287205
301,105,,1,,,行政院,865603,265833,5080,0,3800,1140316,0,146889,0,0,146889,1287205
301,105,,,,,行政支出,865603,265833,5080,0,3800,1140316,0,146889,0,0,146889,1287205
301,105,,,1,,一般行政,839951,69430,1590,0,0,910971,0,2029,0,0,2029,913000
301,105,,,2,,施政及法制業務,0,12359,0,0,0,12359,0,0,0,0,0,12359
301,105,,,3,,施政推展聯繫,0,6250,0,0,0,6250,0,0,0,0,0,6250
301,105,,,4,,科技發展研究諮詢,25652,12998,0,0,0,38650,0,2011,0,0,2011,40661
301,105,,,5,,聯合服務業務,0,27323,0,0,0,27323,0,87792,0,0,87792,115115
301,105,,,6,,國土及資通安全業務,0,8573,0,0,0,8573,0,20,0,0,20,8593
301,105,,,7,,災害防救業務,0,7317,800,0,0,8117,0,0,0,0,0,8117
301,105,,,8,,性別平等業務,0,15274,200,0,0,15474,0,0,0,0,0,15474
301,105,,,9,,消保及食安業務,0,15076,2430,0,0,17506,0,1785,0,0,1785,19291
301,105,,,10,,資訊管理,0,35368,0,0,0,35368,0,34008,0,0,34008,69376
301,105,,,11,,新聞傳播業務,0,55865,60,0,0,55925,0,999,0,0,999,56924
301,105,,,12,,一般建築及設備,0,0,0,0,0,0,0,18245,0,0,18245,18245
301,105,,,,1,營建工程,0,0,0,0,0,0,0,10850,0,0,10850,10850
301,105,,,,2,交通及運輸設備,0,0,0,0,0,0,0,3680,0,0,3680,3680
301,105,,,,3,其他設備,0,0,0,0,0,0,0,3715,0,0,3715,3715
301,105,,,13,,第一預備金,0,0,0,0,3800,3800,0,0,0,0,0,3800
301,106,2,,,,行政院主管,842108,259119,4450,0,3800,1109477,0,135164,0,0,135164,1244641
301,106,,1,,,行政院,842108,259119,4450,0,3800,1109477,0,135164,0,0,135164,1244641
301,106,,,,,行政支出,842108,259119,4450,0,3800,1109477,0,135164,0,0,135164,1244641
301,106,,,1,,一般行政,816496,70159,1590,0,0,888245,0,2029,0,0,2029,890274
301,106,,,2,,施政及法制業務,0,11663,0,0,0,11663,0,0,0,0,0,11663
301,106,,,3,,施政推展聯繫,0,6250,0,0,0,6250,0,0,0,0,0,6250
301,106,,,4,,科技發展研究諮詢,25612,12636,0,0,0,38248,0,2011,0,0,2011,40259
301,106,,,5,,聯合服務業務,0,27193,0,0,0,27193,0,85922,0,0,85922,113115
301,106,,,6,,國土及資通安全業務,0,8533,0,0,0,8533,0,60,0,0,60,8593
301,106,,,7,,災害防救業務,0,7317,800,0,0,8117,0,0,0,0,0,8117
301,106,,,8,,性別平等業務,0,15474,0,0,0,15474,0,0,0,0,0,15474
301,106,,,9,,消保及食安業務,0,15491,2000,0,0,17491,0,90,0,0,90,17581
301,106,,,10,,資訊管理,0,28538,0,0,0,28538,0,33692,0,0,33692,62230
301,106,,,11,,新聞傳播業務,0,55865,60,0,0,55925,0,999,0,0,999,56924
301,106,,,12,,一般建築及設備,0,0,0,0,0,0,0,10361,0,0,10361,10361
301,106,,,,1,營建工程,0,0,0,0,0,0,0,6466,0,0,6466,6466
301,106,,,,2,交通及運輸設備,0,0,0,0,0,0,0,180,0,0,180,180
301,106,,,,3,其他設備,0,0,0,0,0,0,0,3715,0,0,3715,3715
301,106,,,13,,第一預備金,0,0,0,0,3800,3800,0,0,0,0,0,3800
301,107,2,,,,行政院主管,00030000000,836630,249962,3131,0,3800,1093523,0,228000,0,0,228000,1321523
301,107,,1,,,行政院,00030010000,836630,249962,3131,0,3800,1093523,0,228000,0,0,228000,1321523
301,107,,,,,行政支出,33030010000,836630,249962,3131,0,3800,1093523,0,228000,0,0,228000,1321523
301,107,,,1,,一般行政,33030010100,811146,69703,432,0,0,881281,0,2029,0,0,2029,883310
301,107,,,2,,施政及法制業務,33030010700,0,11245,0,0,0,11245,0,0,0,0,0,11245
301,107,,,3,,施政推展聯繫,33030011100,0,6150,0,0,0,6150,0,0,0,0,0,6150
301,107,,,4,,科技發展研究諮詢,33030011500,25484,11478,0,0,0,36962,0,3361,0,0,3361,40323
301,107,,,5,,聯合服務業務,33030011600,0,26793,0,0,0,26793,0,170758,0,0,170758,197551
301,107,,,6,,國土及資通安全業務,33030011800,0,8030,0,0,0,8030,0,60,0,0,60,8090
301,107,,,7,,災害防救業務,33030011900,0,6940,737,0,0,7677,0,0,0,0,0,7677
301,107,,,8,,性別平等業務,33030012000,0,14475,0,0,0,14475,0,0,0,0,0,14475
301,107,,,9,,消保及食安業務,33030012200,0,13541,1922,0,0,15463,0,90,0,0,90,15553
301,107,,,10,,資訊管理,33030012300,0,28836,0,0,0,28836,0,32092,0,0,32092,60928
301,107,,,11,,新聞傳播業務,33030012400,0,52771,40,0,0,52811,0,1609,0,0,1609,54420
301,107,,,12,,一般建築及設備,33030019000,0,0,0,0,0,0,0,18001,0,0,18001,18001
301,107,,,,1,營建工程,33030019002,0,0,0,0,0,0,0,12266,0,0,12266,12266
301,107,,,,2,交通及運輸設備,33030019011,0,0,0,0,0,0,0,2020,0,0,2020,2020
301,107,,,,3,其他設備,33030019019,0,0,0,0,0,0,0,3715,0,0,3715,3715
301,107,,,13,,第一預備金,33030019800,0,0,0,0,3800,3800,0,0,0,0,0,3800
301,108,2,,,,行政院主管,00030000000,878042,269861,3084,0,3800,1154787,0,73883,0,0,73883,1228670
301,108,,1,,,行政院,00030010000,878042,269861,3084,0,3800,1154787,0,73883,0,0,73883,1228670
301,108,,,,,行政支出,33030010000,878042,269861,3084,0,3800,1154787,0,73883,0,0,73883,1228670
301,108,,,1,,一般行政,33030010100,852558,71882,450,0,0,924890,0,2409,0,0,2409,927299
301,108,,,2,,施政及法制業務,33030010700,0,12064,0,0,0,12064,0,0,0,0,0,12064
301,108,,,3,,施政推展聯繫,33030011100,0,6150,0,0,0,6150,0,0,0,0,0,6150
301,108,,,4,,科技發展研究諮詢,33030011500,25484,13009,0,0,0,38493,0,1800,0,0,1800,40293
301,108,,,5,,聯合服務業務,33030011600,0,33624,0,0,0,33624,0,766,0,0,766,34390
301,108,,,6,,國土及資通安全業務,33030011800,0,7959,0,0,0,7959,0,60,0,0,60,8019
301,108,,,7,,災害防救業務,33030011900,0,6650,700,0,0,7350,0,300,0,0,300,7650
301,108,,,8,,性別平等業務,33030012000,0,18819,0,0,0,18819,0,0,0,0,0,18819
301,108,,,9,,消保及食安業務,33030012200,0,13061,1894,0,0,14955,0,0,0,0,0,14955
301,108,,,10,,資訊管理,33030012300,0,34892,0,0,0,34892,0,35458,0,0,35458,70350
301,108,,,11,,新聞傳播業務,33030012400,0,51751,40,0,0,51791,0,1609,0,0,1609,53400
301,108,,,12,,一般建築及設備,33030019000,0,0,0,0,0,0,0,31481,0,0,31481,31481
301,108,,,,1,營建工程,33030019002,0,0,0,0,0,0,0,25736,0,0,25736,25736
301,108,,,,2,交通及運輸設備,33030019011,0,0,0,0,0,0,0,2030,0,0,2030,2030
301,108,,,,3,其他設備,33030019019,0,0,0,0,0,0,0,3715,0,0,3715,3715
301,108,,,13,,第一預備金,33030019800,0,0,0,0,3800,3800,0,0,0,0,0,3800
301,109,2,,,,行政院主管,00030000000,,,,,,,,,,,,
301,109,,1,,,行政院,00030010000,885696,266533,3020,0,3800,1159049,0,145457,0,0,145457,1304506
301,109,,,,,行政支出,32030010000,885696,266533,3020,0,3800,1159049,0,145457,0,0,145457,1304506
301,109,,,1,,一般行政,32030010100,860212,73513,450,0,0,934175,0,2909,0,0,2909,937084
301,109,,,2,,施政及法制業務,32030010700,0,12228,0,0,0,12228,0,0,0,0,0,12228
301,109,,,3,,施政推展聯繫,32030011100,0,6150,0,0,0,6150,0,0,0,0,0,6150
301,109,,,4,,科技發展研究諮詢,32030011500,25484,12509,0,0,0,37993,0,1800,0,0,1800,39793
301,109,,,5,,聯合服務業務,32030011600,0,33784,0,0,0,33784,0,606,0,0,606,34390
301,109,,,6,,國土及資通安全業務,32030011800,0,7959,0,0,0,7959,0,60,0,0,60,8019
301,109,,,7,,災害防救業務,32030011900,0,7150,672,0,0,7822,0,100,0,0,100,7922
301,109,,,8,,性別平等業務,32030012000,0,18239,0,0,0,18239,0,0,0,0,0,18239
301,109,,,9,,消保及食安業務,32030012200,0,12561,1858,0,0,14419,0,0,0,0,0,14419
301,109,,,10,,資訊管理,32030012300,0,31892,0,0,0,31892,0,34220,0,0,34220,66112
301,109,,,11,,新聞傳播業務,32030012400,0,50548,40,0,0,50588,0,1619,0,0,1619,52207
301,109,,,12,,一般建築及設備,32030019000,0,0,0,0,0,0,0,104143,0,0,104143,104143
301,109,,,,1,營建工程,32030019002,0,0,0,0,0,0,0,94888,0,0,94888,94888
301,109,,,,2,交通及運輸設備,32030019011,0,0,0,0,0,0,0,5540,0,0,5540,5540
301,109,,,,3,其他設備,32030019019,0,0,0,0,0,0,0,3715,0,0,3715,3715
301,109,,,13,,第一預備金,32030019800,0,0,0,0,3800,3800,0,0,0,0,0,3800
301,110,2,,,,行政院主管,00030000000,,,,,,,,,,,,
301,110,,1,,,行政院,00030010000,893845,256663,2955,0,3800,1157263,0,148489,0,0,148489,1305752
301,110,,,,,行政支出,32030010000,893845,256663,2955,0,3800,1157263,0,148489,0,0,148489,1305752
301,110,,,1,,一般行政,32030010100,868361,72513,450,0,0,941324,0,2909,0,0,2909,944233
301,110,,,2,,施政及法制業務,32030010700,0,12228,0,0,0,12228,0,0,0,0,0,12228
301,110,,,3,,施政推展聯繫,32030011100,0,6150,0,0,0,6150,0,0,0,0,0,6150
301,110,,,4,,科技發展研究諮詢,32030011500,25484,12209,0,0,0,37693,0,2100,0,0,2100,39793
301,110,,,5,,聯合服務業務,32030011600,0,33689,0,0,0,33689,0,626,0,0,626,34315
301,110,,,6,,國土及資通安全業務,32030011800,0,7739,0,0,0,7739,0,80,0,0,80,7819
301,110,,,7,,災害防救業務,32030011900,0,7544,641,0,0,8185,0,60,0,0,60,8245
301,110,,,8,,性別平等業務,32030012000,0,14232,0,0,0,14232,0,0,0,0,0,14232
301,110,,,9,,消保及食安業務,32030012200,0,11714,1824,0,0,13538,0,0,0,0,0,13538
301,110,,,10,,資訊管理,32030012300,0,31724,0,0,0,31724,0,21560,0,0,21560,53284
301,110,,,11,,新聞傳播業務,32030012400,0,46921,40,0,0,46961,0,1619,0,0,1619,48580
301,110,,,12,,一般建築及設備,32030019000,0,0,0,0,0,0,0,119535,0,0,119535,119535
301,110,,,,1,營建工程,32030019002,0,0,0,0,0,0,0,110640,0,0,110640,110640
301,110,,,,2,交通及運輸設備,32030019011,0,0,0,0,0,0,0,5180,0,0,5180,5180
301,110,,,,3,其他設備,32030019019,0,0,0,0,0,0,0,3715,0,0,3715,3715
301,110,,,13,,第一預備金,32030019800,0,0,0,0,3800,3800,0,0,0,0,0,3800
301,111,2,,,,行政院主管,00030000000,,,,,,,,,,,,
301,111,,1,,,行政院,00030010000,906278,279278,2949,0,3800,1192305,0,63738,0,0,63738,1256043
301,111,,,,,行政支出,32030010000,906278,279278,2949,0,3800,1192305,0,63738,0,0,63738,1256043
301,111,,,1,,一般行政,32030010100,880794,73673,450,0,0,954917,0,2909,0,0,2909,957826
301,111,,,2,,施政及法制業務,32030010700,0,12156,0,0,0,12156,0,0,0,0,0,12156
301,111,,,3,,施政推展聯繫,32030011100,0,6150,0,0,0,6150,0,0,0,0,0,6150
301,111,,,4,,科技發展研究諮詢,32030011500,25484,10416,0,0,0,35900,0,1900,0,0,1900,37800
301,111,,,5,,聯合服務業務,32030011600,0,32789,0,0,0,32789,0,676,0,0,676,33465
301,111,,,6,,國土及資通安全業務,32030011800,0,7729,0,0,0,7729,0,90,0,0,90,7819
301,111,,,7,,災害防救業務,32030011900,0,9713,550,0,0,10263,0,20,0,0,20,10283
301,111,,,8,,性別平等業務,32030012000,0,20403,0,0,0,20403,0,0,0,0,0,20403
301,111,,,9,,消保及食安業務,32030012200,0,10974,1909,0,0,12883,0,40,0,0,40,12923
301,111,,,10,,資訊管理,32030012300,0,31024,0,0,0,31024,0,20617,0,0,20617,51641
301,111,,,11,,新聞傳播業務,32030012400,0,42410,40,0,0,42450,0,2019,0,0,2019,44469
301,111,,,12,,數位發展部籌備工作,32030012700,0,21841,0,0,0,21841,0,20084,0,0,20084,41925
301,111,,,13,,一般建築及設備,32030019000,0,0,0,0,0,0,0,15383,0,0,15383,15383
301,111,,,,1,營建工程,32030019002,0,0,0,0,0,0,0,8178,0,0,8178,8178
301,111,,,,2,交通及運輸設備,32030019011,0,0,0,0,0,0,0,3490,0,0,3490,3490
301,111,,,,3,其他設備,32030019019,0,0,0,0,0,0,0,3715,0,0,3715,3715
301,111,,,14,,第一預備金,32030019800,0,0,0,0,3800,3800,0,0,0,0,0,3800
301,112,2,,,,行政院主管,00030000000,,,,,,,,,,,,
301,112,,1,,,行政院,00030010000,978415,259130,2996,0,3800,1244341,0,78536,0,0,78536,1322877
301,112,,,,,行政支出,32030010000,978415,259130,2996,0,3800,1244341,0,78536,0,0,78536,1322877
301,112,,,1,,一般行政,32030010100,978415,79653,450,0,0,1058518,0,3029,0,0,3029,1061547
301,112,,,2,,施政及法制業務,32030010700,0,12280,0,0,0,12280,0,0,0,0,0,12280
301,112,,,3,,施政推展聯繫,32030011100,0,6150,0,0,0,6150,0,0,0,0,0,6150
301,112,,,4,,聯合服務業務,32030011600,0,31733,0,0,0,31733,0,662,0,0,662,32395
301,112,,,5,,災害防救及國土安全,32030011900,0,17668,522,0,0,18190,0,59,0,0,59,18249
301,112,,,6,,性別平等業務,32030012000,0,17078,0,0,0,17078,0,0,0,0,0,17078
301,112,,,7,,消保及食安業務,32030012200,0,10261,2004,0,0,12265,0,0,0,0,0,12265
301,112,,,8,,資訊管理,32030012300,0,31834,0,0,0,31834,0,26115,0,0,26115,57949
301,112,,,9,,新聞傳播業務,32030012400,0,38209,20,0,0,38229,0,959,0,0,959,39188
301,112,,,11,,人權及轉型正義,32030012800,0,14264,0,0,0,14264,0,0,0,0,0,14264
301,112,,,12,,一般建築及設備,32030019000,0,0,0,0,0,0,0,47712,0,0,47712,47712
301,112,,,,1,營建工程,32030019002,0,0,0,0,0,0,0,40100,0,0,40100,40100
301,112,,,,2,交通及運輸設備,32030019011,0,0,0,0,0,0,0,3620,0,0,3620,3620
301,112,,,,3,其他設備,32030019019,0,0,0,0,0,0,0,3992,0,0,3992,3992
301,112,,,13,,第一預備金,32030019800,0,0,0,0,3800,3800,0,0,0,0,0,3800
301,113,2,,,,行政院主管,00030000000,,,,,,,,,,,,
301,113,,1,,,行政院,00030010000,996619,310241,3624,0,3800,1314284,0,122365,0,0,122365,1436649
301,113,,,,,行政支出,32030010000,996619,310241,3624,0,3800,1314284,0,122365,0,0,122365,1436649
301,113,,,1,,一般行政,32030010100,958619,85396,450,0,0,1044465,0,3029,0,0,3029,1047494
301,113,,,2,,施政及法制業務,32030010700,0,13412,0,0,0,13412,0,0,0,0,0,13412
301,113,,,3,,施政推展聯繫,32030011100,0,6150,0,0,0,6150,0,0,0,0,0,6150
301,113,,,4,,聯合服務業務,32030011600,0,30710,0,0,0,30710,0,654,0,0,654,31364
301,113,,,5,,災害防救及國土安全,32030011900,0,14161,1200,0,0,15361,0,127,0,0,127,15488
301,113,,,6,,性別平等業務,32030012000,0,15959,0,0,0,15959,0,0,0,0,0,15959
301,113,,,7,,消保及食安業務,32030012200,0,9860,1954,0,0,11814,0,0,0,0,0,11814
301,113,,,8,,資訊管理,32030012300,0,29334,0,0,0,29334,0,28870,0,0,28870,58204
301,113,,,9,,新聞傳播業務,32030012400,0,43223,20,0,0,43243,0,977,0,0,977,44220
301,113,,,11,,人權及轉型正義,32030012800,0,13593,0,0,0,13593,0,0,0,0,0,13593
301,113,,,12,,個資保護委員會籌備業務,32030013000,38000,48443,0,0,0,86443,0,31365,0,0,31365,117808
301,113,,,13,,一般建築及設備,32030019000,0,0,0,0,0,0,0,57343,0,0,57343,57343
301,113,,,,1,營建工程,32030019002,0,0,0,0,0,0,0,49549,0,0,49549,49549
301,113,,,,2,交通及運輸設備,32030019011,0,0,0,0,0,0,0,3802,0,0,3802,3802
301,113,,,,3,其他設備,32030019019,0,0,0,0,0,0,0,3992,0,0,3992,3992
301,113,,,14,,第一預備金,32030019800,0,0,0,0,3800,3800,0,0,0,0,0,3800
401,105,3,,,,立法院主管,2484492,801163,17420,0,3000,3306075,0,374052,0,0,374052,3680127
401,105,,1,,,立法院,2484492,801163,17420,0,3000,3306075,0,374052,0,0,374052,3680127
401,105,,,,,立法支出,2484492,801163,17420,0,3000,3306075,0,374052,0,0,374052,3680127
401,105,,,1,,一般行政,1334131,492168,3860,0,0,1830159,0,35702,0,0,35702,1865861
401,105,,,2,,委員問政業務,1150361,246490,0,0,0,1396851,0,0,0,0,0,1396851
401,105,,,,1,委員歲費及公費,292725,0,0,0,0,292725,0,0,0,0,0,292725
401,105,,,,2,公費助理,772994,0,0,0,0,772994,0,0,0,0,0,772994
401,105,,,,3,國會交流事務,0,42600,0,0,0,42600,0,0,0,0,0,42600
401,105,,,,4,委員會館,0,138366,0,0,0,138366,0,0,0,0,0,138366
401,105,,,,5,問政相關業務,84642,65524,0,0,0,150166,0,0,0,0,0,150166
401,105,,,3,,議事業務,0,10715,0,0,0,10715,0,0,0,0,0,10715
401,105,,,4,,立法諮詢業務,0,5480,0,0,0,5480,0,0,0,0,0,5480
401,105,,,5,,國會圖書業務,0,19163,0,0,0,19163,0,21940,0,0,21940,41103
401,105,,,6,,公報業務,0,27147,0,0,0,27147,0,0,0,0,0,27147
401,105,,,7,,黨團補助,0,0,13560,0,0,13560,0,0,0,0,0,13560
401,105,,,8,,一般建築及設備,0,0,0,0,0,0,0,316410,0,0,316410,316410
401,105,,,,1,營建工程,0,0,0,0,0,0,0,15000,0,0,15000,15000
401,105,,,,2,交通及運輸設備,0,0,0,0,0,0,0,12060,0,0,12060,12060
401,105,,,,3,其他設備,0,0,0,0,0,0,0,289350,0,0,289350,289350
401,105,,,9,,第一預備金,0,0,0,0,3000,3000,0,0,0,0,0,3000
401,106,3,,,,立法院主管,00040000000,2360164,765310,14580,0,3000,3143054,0,319589,0,0,319589,3462643
401,106,,1,,,立法院,00040010000,2360164,765310,14580,0,3000,3143054,0,319589,0,0,319589,3462643
401,106,,,,,立法支出,34040010000,2360164,765310,14580,0,3000,3143054,0,319589,0,0,319589,3462643
401,106,,,1,,一般行政,34040010100,1211674,475617,1020,0,0,1688311,0,22158,0,0,22158,1710469
401,106,,,2,,委員問政業務,34040010200,1148490,201428,0,0,0,1349918,0,0,0,0,0,1349918
401,106,,,,1,委員歲費及公費,34040010201,292725,0,0,0,0,292725,0,0,0,0,0,292725
401,106,,,,2,公費助理,34040010203,772994,0,0,0,0,772994,0,0,0,0,0,772994
401,106,,,,3,國會交流事務,34040010204,0,42600,0,0,0,42600,0,0,0,0,0,42600
401,106,,,,4,委員會館,34040010205,0,102132,0,0,0,102132,0,0,0,0,0,102132
401,106,,,,5,問政相關業務,34040010206,82771,56696,0,0,0,139467,0,0,0,0,0,139467
401,106,,,3,,議事業務,34040010300,0,10124,0,0,0,10124,0,0,0,0,0,10124
401,106,,,4,,立法諮詢業務,34040010400,0,4936,0,0,0,4936,0,0,0,0,0,4936
401,106,,,5,,國會圖書業務,34040010500,0,19258,0,0,0,19258,0,21953,0,0,21953,41211
401,106,,,6,,公報業務,34040010600,0,53947,0,0,0,53947,0,0,0,0,0,53947
401,106,,,7,,黨團補助,34040010700,0,0,13560,0,0,13560,0,0,0,0,0,13560
401,106,,,8,,一般建築及設備,34040019000,0,0,0,0,0,0,0,275478,0,0,275478,275478
401,106,,,,1,土地購置,34040019001,0,0,0,0,0,0,0,104875,0,0,104875,104875
401,106,,,,2,營建工程,34040019002,0,0,0,0,0,0,0,18000,0,0,18000,18000
401,106,,,,3,交通及運輸設備,34040019011,0,0,0,0,0,0,0,12023,0,0,12023,12023
401,106,,,,4,其他設備,34040019019,0,0,0,0,0,0,0,140580,0,0,140580,140580
401,106,,,9,,第一預備金,34040019800,0,0,0,0,3000,3000,0,0,0,0,0,3000
401,107,3,,,,立法院主管,00040000000,2371214,808811,14667,0,3000,3197692,0,306689,0,0,306689,3504381
401,107,,1,,,立法院,00040010000,2371214,808811,14667,0,3000,3197692,0,306689,0,0,306689,3504381
401,107,,,,,立法支出,34040010000,2371214,808811,14667,0,3000,3197692,0,306689,0,0,306689,3504381
401,107,,,1,,一般行政,34040010100,1221911,452662,1107,0,0,1675680,0,34025,0,0,34025,1709705
401,107,,,2,,委員問政業務,34040010200,1149303,198028,0,0,0,1347331,0,0,0,0,0,1347331
401,107,,,,1,委員歲費及公費,34040010201,292725,0,0,0,0,292725,0,0,0,0,0,292725
401,107,,,,2,公費助理,34040010203,772994,0,0,0,0,772994,0,0,0,0,0,772994
401,107,,,,3,國會交流事務,34040010204,0,42600,0,0,0,42600,0,0,0,0,0,42600
401,107,,,,4,委員會館,34040010205,0,98732,0,0,0,98732,0,0,0,0,0,98732
401,107,,,,5,問政相關業務,34040010206,83584,56696,0,0,0,140280,0,0,0,0,0,140280
401,107,,,3,,議事業務,34040010300,0,11264,0,0,0,11264,0,0,0,0,0,11264
401,107,,,4,,立法諮詢業務,34040010400,0,3786,0,0,0,3786,0,0,0,0,0,3786
401,107,,,5,,國會圖書業務,34040010500,0,23178,0,0,0,23178,0,24196,0,0,24196,47374
401,107,,,6,,公報業務,34040010600,0,119893,0,0,0,119893,0,0,0,0,0,119893
401,107,,,7,,黨團補助,34040010700,0,0,13560,0,0,13560,0,0,0,0,0,13560
401,107,,,8,,一般建築及設備,34040019000,0,0,0,0,0,0,0,248468,0,0,248468,248468
401,107,,,,1,土地購置,34040019001,0,0,0,0,0,0,0,94880,0,0,94880,94880
401,107,,,,2,營建工程,34040019002,0,0,0,0,0,0,0,16380,0,0,16380,16380
401,107,,,,3,交通及運輸設備,34040019011,0,0,0,0,0,0,0,11960,0,0,11960,11960
401,107,,,,4,其他設備,34040019019,0,0,0,0,0,0,0,125248,0,0,125248,125248
401,107,,,9,,第一預備金,34040019800,0,0,0,0,3000,3000,0,0,0,0,0,3000
401,108,3,,,,立法院主管,00040000000,2480879,757024,14733,0,3000,3255636,0,190105,0,0,190105,3445741
401,108,,1,,,立法院,00040010000,2480879,757024,14733,0,3000,3255636,0,190105,0,0,190105,3445741
401,108,,,,,立法支出,34040010000,2480879,757024,14733,0,3000,3255636,0,190105,0,0,190105,3445741
401,108,,,1,,一般行政,34040010100,1294561,398038,1173,0,0,1693772,0,24625,0,0,24625,1718397
401,108,,,2,,委員問政業務,34040010200,1186318,201172,0,0,0,1387490,0,0,0,0,0,1387490
401,108,,,,1,委員歲費及公費,34040010201,301668,0,0,0,0,301668,0,0,0,0,0,301668
401,108,,,,2,公費助理,34040010203,796184,0,0,0,0,796184,0,0,0,0,0,796184
401,108,,,,3,國會交流事務,34040010204,0,44600,0,0,0,44600,0,0,0,0,0,44600
401,108,,,,4,委員會館,34040010205,0,101409,0,0,0,101409,0,0,0,0,0,101409
401,108,,,,5,問政相關業務,34040010206,88466,55163,0,0,0,143629,0,0,0,0,0,143629
401,108,,,3,,議事業務,34040010300,0,11126,0,0,0,11126,0,0,0,0,0,11126
401,108,,,4,,立法諮詢業務,34040010400,0,2808,0,0,0,2808,0,0,0,0,0,2808
401,108,,,5,,國會圖書業務,34040010500,0,25567,0,0,0,25567,0,24657,0,0,24657,50224
401,108,,,6,,公報業務,34040010600,0,118313,0,0,0,118313,0,0,0,0,0,118313
401,108,,,7,,黨團補助,34040010700,0,0,13560,0,0,13560,0,0,0,0,0,13560
401,108,,,8,,一般建築及設備,34040019000,0,0,0,0,0,0,0,140823,0,0,140823,140823
401,108,,,,2,營建工程,34040019002,0,0,0,0,0,0,0,21280,0,0,21280,21280
401,108,,,,3,交通及運輸設備,34040019011,0,0,0,0,0,0,0,7840,0,0,7840,7840
401,108,,,,4,其他設備,34040019019,0,0,0,0,0,0,0,111703,0,0,111703,111703
401,108,,,9,,第一預備金,34040019800,0,0,0,0,3000,3000,0,0,0,0,0,3000
401,109,3,,,,立法院主管,00040000000,,,,,,,,,,,,
401,109,,1,,,立法院,00040010000,2482425,794181,14757,0,3000,3294363,0,219487,0,0,219487,3513850
401,109,,,,,立法支出,33040010000,2482425,794181,14757,0,3000,3294363,0,219487,0,0,219487,3513850
401,109,,,1,,一般行政,33040010100,1297246,401326,1197,0,0,1699769,0,28313,0,0,28313,1728082
401,109,,,2,,委員問政業務,33040010200,1185179,234775,0,0,0,1419954,0,0,0,0,0,1419954
401,109,,,,1,委員歲費及公費,33040010201,301668,0,0,0,0,301668,0,0,0,0,0,301668
401,109,,,,2,公費助理,33040010203,796184,0,0,0,0,796184,0,0,0,0,0,796184
401,109,,,,3,國會交流事務,33040010204,0,42600,0,0,0,42600,0,0,0,0,0,42600
401,109,,,,4,委員會館,33040010205,0,130151,0,0,0,130151,0,0,0,0,0,130151
401,109,,,,5,問政相關業務,33040010206,87327,62024,0,0,0,149351,0,0,0,0,0,149351
401,109,,,3,,議事業務,33040010300,0,11126,0,0,0,11126,0,0,0,0,0,11126
401,109,,,4,,立法諮詢業務,33040010400,0,2050,0,0,0,2050,0,0,0,0,0,2050
401,109,,,5,,國會圖書業務,33040010500,0,25476,0,0,0,25476,0,25028,0,0,25028,50504
401,109,,,6,,公報業務,33040010600,0,119428,0,0,0,119428,0,0,0,0,0,119428
401,109,,,7,,黨團補助,33040010700,0,0,13560,0,0,13560,0,0,0,0,0,13560
401,109,,,8,,一般建築及設備,33040019000,0,0,0,0,0,0,0,166146,0,0,166146,166146
401,109,,,,1,營建工程,33040019002,0,0,0,0,0,0,0,22074,0,0,22074,22074
401,109,,,,2,交通及運輸設備,33040019011,0,0,0,0,0,0,0,10570,0,0,10570,10570
401,109,,,,3,其他設備,33040019019,0,0,0,0,0,0,0,133502,0,0,133502,133502
401,109,,,9,,第一預備金,33040019800,0,0,0,0,3000,3000,0,0,0,0,0,3000
401,110,3,,,,立法院主管,00040000000,,,,,,,,,,,,
401,110,,1,,,立法院,00040010000,2455731,739222,15208,0,3000,3213161,0,188780,0,0,188780,3401941
401,110,,,,,立法支出,33040010000,2455731,739222,15208,0,3000,3213161,0,188780,0,0,188780,3401941
401,110,,,1,,一般行政,33040010100,1273318,389262,1648,0,0,1664228,0,28537,0,0,28537,1692765
401,110,,,2,,委員問政業務,33040010200,1182413,186650,0,0,0,1369063,0,0,0,0,0,1369063
401,110,,,,1,委員歲費及公費,33040010201,301668,0,0,0,0,301668,0,0,0,0,0,301668
401,110,,,,2,公費助理,33040010203,796184,0,0,0,0,796184,0,0,0,0,0,796184
401,110,,,,3,國會交流事務,33040010204,0,41380,0,0,0,41380,0,0,0,0,0,41380
401,110,,,,4,委員會館,33040010205,0,91877,0,0,0,91877,0,0,0,0,0,91877
401,110,,,,5,問政相關業務,33040010206,84561,53393,0,0,0,137954,0,0,0,0,0,137954
401,110,,,3,,議事業務,33040010300,0,10724,0,0,0,10724,0,0,0,0,0,10724
401,110,,,4,,立法諮詢業務,33040010400,0,1645,0,0,0,1645,0,0,0,0,0,1645
401,110,,,5,,國會圖書業務,33040010500,0,24381,0,0,0,24381,0,21230,0,0,21230,45611
401,110,,,6,,公報業務,33040010600,0,126560,0,0,0,126560,0,0,0,0,0,126560
401,110,,,7,,黨團補助,33040010700,0,0,13560,0,0,13560,0,0,0,0,0,13560
401,110,,,8,,一般建築及設備,33040019000,0,0,0,0,0,0,0,139013,0,0,139013,139013
401,110,,,,1,營建工程,33040019002,0,0,0,0,0,0,0,5530,0,0,5530,5530
401,110,,,,2,交通及運輸設備,33040019011,0,0,0,0,0,0,0,13170,0,0,13170,13170
401,110,,,,3,其他設備,33040019019,0,0,0,0,0,0,0,120313,0,0,120313,120313
401,110,,,9,,第一預備金,33040019800,0,0,0,0,3000,3000,0,0,0,0,0,3000
401,111,3,,,,立法院主管,00040000000,,,,,,,,,,,,
401,111,,1,,,立法院,00040010000,2460180,742018,15550,0,3000,3220748,0,206555,0,0,206555,3427303
401,111,,,,,立法支出,33040010000,2460180,742018,15550,0,3000,3220748,0,206555,0,0,206555,3427303
401,111,,,1,,一般行政,33040010100,1274188,399830,1690,0,0,1675708,0,18465,0,0,18465,1694173
401,111,,,2,,委員問政業務,33040010200,1185992,184130,0,0,0,1370122,0,0,0,0,0,1370122
401,111,,,,1,委員歲費及公費,33040010201,301668,0,0,0,0,301668,0,0,0,0,0,301668
401,111,,,,2,公費助理,33040010203,796184,0,0,0,0,796184,0,0,0,0,0,796184
401,111,,,,3,國會交流事務,33040010204,0,42600,0,0,0,42600,0,0,0,0,0,42600
401,111,,,,4,委員會館,33040010205,0,88134,0,0,0,88134,0,0,0,0,0,88134
401,111,,,,5,問政相關業務,33040010206,88140,53396,0,0,0,141536,0,0,0,0,0,141536
401,111,,,3,,議事業務,33040010300,0,10686,0,0,0,10686,0,0,0,0,0,10686
401,111,,,4,,立法諮詢業務,33040010400,0,1348,0,0,0,1348,0,0,0,0,0,1348
401,111,,,5,,國會圖書業務,33040010500,0,22558,300,0,0,22858,0,22500,0,0,22500,45358
401,111,,,6,,公報業務,33040010600,0,123466,0,0,0,123466,0,0,0,0,0,123466
401,111,,,7,,黨團補助,33040010700,0,0,13560,0,0,13560,0,0,0,0,0,13560
401,111,,,8,,一般建築及設備,33040019000,0,0,0,0,0,0,0,165590,0,0,165590,165590
401,111,,,,1,營建工程,33040019002,0,0,0,0,0,0,0,43086,0,0,43086,43086
401,111,,,,2,交通及運輸設備,33040019011,0,0,0,0,0,0,0,8450,0,0,8450,8450
401,111,,,,3,其他設備,33040019019,0,0,0,0,0,0,0,114054,0,0,114054,114054
401,111,,,9,,第一預備金,33040019800,0,0,0,0,3000,3000,0,0,0,0,0,3000
401,112,3,,,,立法院主管,00040000000,,,,,,,,,,,,
401,112,,1,,,立法院,00040010000,2555081,742420,15699,0,3000,3316200,0,290083,0,0,290083,3606283
401,112,,,,,立法支出,33040010000,2555081,742420,15699,0,3000,3316200,0,290083,0,0,290083,3606283
401,112,,,1,,一般行政,33040010100,1323884,401549,1839,0,0,1727272,0,22631,0,0,22631,1749903
401,112,,,2,,委員問政業務,33040010200,1231197,183676,0,0,0,1414873,0,0,0,0,0,1414873
401,112,,,,1,委員歲費及公費,33040010201,313963,0,0,0,0,313963,0,0,0,0,0,313963
401,112,,,,2,公費助理,33040010203,828036,0,0,0,0,828036,0,0,0,0,0,828036
401,112,,,,3,國會交流事務,33040010204,0,41600,0,0,0,41600,0,0,0,0,0,41600
401,112,,,,4,委員會館,33040010205,0,88701,0,0,0,88701,0,0,0,0,0,88701
401,112,,,,5,問政相關業務,33040010206,89198,53375,0,0,0,142573,0,0,0,0,0,142573
401,112,,,3,,議事業務,33040010300,0,10528,0,0,0,10528,0,0,0,0,0,10528
401,112,,,4,,立法諮詢業務,33040010400,0,1098,0,0,0,1098,0,0,0,0,0,1098
401,112,,,5,,國會圖書業務,33040010500,0,22602,300,0,0,22902,0,21450,0,0,21450,44352
401,112,,,6,,公報業務,33040010600,0,122967,0,0,0,122967,0,0,0,0,0,122967
401,112,,,7,,黨團補助,33040010700,0,0,13560,0,0,13560,0,0,0,0,0,13560
401,112,,,8,,一般建築及設備,33040019000,0,0,0,0,0,0,0,246002,0,0,246002,246002
401,112,,,,1,營建工程,33040019002,0,0,0,0,0,0,0,139551,0,0,139551,139551
401,112,,,,2,交通及運輸設備,33040019011,0,0,0,0,0,0,0,2760,0,0,2760,2760
401,112,,,,3,其他設備,33040019019,0,0,0,0,0,0,0,103691,0,0,103691,103691
401,112,,,9,,第一預備金,33040019800,0,0,0,0,3000,3000,0,0,0,0,0,3000
401,105,3,,,,立法院主管,2489156,801262,17420,0,3000,3310838,0,374052,0,0,374052,3684890
401,105,,1,,,立法院,2489156,801262,17420,0,3000,3310838,0,374052,0,0,374052,3684890
401,105,,,,,立法支出,2489156,801262,17420,0,3000,3310838,0,374052,0,0,374052,3684890
401,105,,,1,,一般行政,1338795,492168,3860,0,0,1834823,0,35702,0,0,35702,1870525
401,105,,,2,,委員問政業務,1150361,246490,0,0,0,1396851,0,0,0,0,0,1396851
401,105,,,,1,委員歲費及公費,292725,0,0,0,0,292725,0,0,0,0,0,292725
401,105,,,,2,公費助理,772994,0,0,0,0,772994,0,0,0,0,0,772994
401,105,,,,3,國會交流事務,0,42600,0,0,0,42600,0,0,0,0,0,42600
401,105,,,,4,委員會館,0,138366,0,0,0,138366,0,0,0,0,0,138366
401,105,,,,5,問政相關業務,84642,65524,0,0,0,150166,0,0,0,0,0,150166
401,105,,,3,,議事業務,0,10784,0,0,0,10784,0,0,0,0,0,10784
401,105,,,4,,立法諮詢業務,0,5480,0,0,0,5480,0,0,0,0,0,5480
401,105,,,5,,國會圖書業務,0,19193,0,0,0,19193,0,21940,0,0,21940,41133
401,105,,,6,,公報業務,0,27147,0,0,0,27147,0,0,0,0,0,27147
401,105,,,7,,黨團補助,0,0,13560,0,0,13560,0,0,0,0,0,13560
401,105,,,8,,一般建築及設備,0,0,0,0,0,0,0,316410,0,0,316410,316410
401,105,,,,1,營建工程,0,0,0,0,0,0,0,15000,0,0,15000,15000
401,105,,,,2,交通及運輸設備,0,0,0,0,0,0,0,12060,0,0,12060,12060
401,105,,,,3,其他設備,0,0,0,0,0,0,0,289350,0,0,289350,289350
401,105,,,9,,第一預備金,0,0,0,0,3000,3000,0,0,0,0,0,3000
401,106,3,,,,立法院主管,2360164,776032,17472,0,3000,3156668,0,333927,0,0,333927,3490595
401,106,,1,,,立法院,2360164,776032,17472,0,3000,3156668,0,333927,0,0,333927,3490595
401,106,,,,,立法支出,2360164,776032,17472,0,3000,3156668,0,333927,0,0,333927,3490595
401,106,,,1,,一般行政,1211674,482693,3912,0,0,1698279,0,27757,0,0,27757,1726036
401,106,,,2,,委員問政業務,1148490,203356,0,0,0,1351846,0,0,0,0,0,1351846
401,106,,,,1,委員歲費及公費,292725,0,0,0,0,292725,0,0,0,0,0,292725
401,106,,,,2,公費助理,772994,0,0,0,0,772994,0,0,0,0,0,772994
401,106,,,,3,國會交流事務,0,42600,0,0,0,42600,0,0,0,0,0,42600
401,106,,,,4,委員會館,0,104060,0,0,0,104060,0,0,0,0,0,104060
401,106,,,,5,問政相關業務,82771,56696,0,0,0,139467,0,0,0,0,0,139467
401,106,,,3,,議事業務,0,10124,0,0,0,10124,0,0,0,0,0,10124
401,106,,,4,,立法諮詢業務,0,5180,0,0,0,5180,0,0,0,0,0,5180
401,106,,,5,,國會圖書業務,0,19732,0,0,0,19732,0,22703,0,0,22703,42435
401,106,,,6,,公報業務,0,54947,0,0,0,54947,0,0,0,0,0,54947
401,106,,,7,,黨團補助,0,0,13560,0,0,13560,0,0,0,0,0,13560
401,106,,,8,,一般建築及設備,0,0,0,0,0,0,0,283467,0,0,283467,283467
401,106,,,,1,土地購置,0,0,0,0,0,0,0,104875,0,0,104875,104875
401,106,,,,2,營建工程,0,0,0,0,0,0,0,18000,0,0,18000,18000
401,106,,,,3,交通及運輸設備,0,0,0,0,0,0,0,12023,0,0,12023,12023
401,106,,,,4,其他設備,0,0,0,0,0,0,0,148569,0,0,148569,148569
401,106,,,9,,第一預備金,0,0,0,0,3000,3000,0,0,0,0,0,3000
401,107,3,,,,立法院主管,00040000000,2371214,821313,14667,0,3000,3210194,0,332133,0,0,332133,3542327
401,107,,1,,,立法院,00040010000,2371214,821313,14667,0,3000,3210194,0,332133,0,0,332133,3542327
401,107,,,,,立法支出,34040010000,2371214,821313,14667,0,3000,3210194,0,332133,0,0,332133,3542327
401,107,,,1,,一般行政,34040010100,1221911,458062,1107,0,0,1681080,0,38899,0,0,38899,1719979
401,107,,,2,,委員問政業務,34040010200,1149303,201561,0,0,0,1350864,0,0,0,0,0,1350864
401,107,,,,1,委員歲費及公費,34040010201,292725,0,0,0,0,292725,0,0,0,0,0,292725
401,107,,,,2,公費助理,34040010203,772994,0,0,0,0,772994,0,0,0,0,0,772994
401,107,,,,3,國會交流事務,34040010204,0,44600,0,0,0,44600,0,0,0,0,0,44600
401,107,,,,4,委員會館,34040010205,0,100265,0,0,0,100265,0,0,0,0,0,100265
401,107,,,,5,問政相關業務,34040010206,83584,56696,0,0,0,140280,0,0,0,0,0,140280
401,107,,,3,,議事業務,34040010300,0,11264,0,0,0,11264,0,0,0,0,0,11264
401,107,,,4,,立法諮詢業務,34040010400,0,4486,0,0,0,4486,0,0,0,0,0,4486
401,107,,,5,,國會圖書業務,34040010500,0,23207,0,0,0,23207,0,24196,0,0,24196,47403
401,107,,,6,,公報業務,34040010600,0,122733,0,0,0,122733,0,0,0,0,0,122733
401,107,,,7,,黨團補助,34040010700,0,0,13560,0,0,13560,0,0,0,0,0,13560
401,107,,,8,,一般建築及設備,34040019000,0,0,0,0,0,0,0,269038,0,0,269038,269038
401,107,,,,1,土地購置,34040019001,0,0,0,0,0,0,0,94880,0,0,94880,94880
401,107,,,,2,營建工程,34040019002,0,0,0,0,0,0,0,18200,0,0,18200,18200
401,107,,,,3,交通及運輸設備,34040019011,0,0,0,0,0,0,0,11960,0,0,11960,11960
401,107,,,,4,其他設備,34040019019,0,0,0,0,0,0,0,143998,0,0,143998,143998
401,107,,,9,,第一預備金,34040019800,0,0,0,0,3000,3000,0,0,0,0,0,3000
401,108,3,,,,立法院主管,00040000000,2480879,770708,14733,0,3000,3269320,0,195178,0,0,195178,3464498
401,108,,1,,,立法院,00040010000,2480879,770708,14733,0,3000,3269320,0,195178,0,0,195178,3464498
401,108,,,,,立法支出,34040010000,2480879,770708,14733,0,3000,3269320,0,195178,0,0,195178,3464498
401,108,,,1,,一般行政,34040010100,1294561,406306,1173,0,0,1702040,0,26053,0,0,26053,1728093
401,108,,,2,,委員問政業務,34040010200,1186318,203071,0,0,0,1389389,0,0,0,0,0,1389389
401,108,,,,1,委員歲費及公費,34040010201,301668,0,0,0,0,301668,0,0,0,0,0,301668
401,108,,,,2,公費助理,34040010203,796184,0,0,0,0,796184,0,0,0,0,0,796184
401,108,,,,3,國會交流事務,34040010204,0,44600,0,0,0,44600,0,0,0,0,0,44600
401,108,,,,4,委員會館,34040010205,0,102075,0,0,0,102075,0,0,0,0,0,102075
401,108,,,,5,問政相關業務,34040010206,88466,56396,0,0,0,144862,0,0,0,0,0,144862
401,108,,,3,,議事業務,34040010300,0,11148,0,0,0,11148,0,0,0,0,0,11148
401,108,,,4,,立法諮詢業務,34040010400,0,3086,0,0,0,3086,0,0,0,0,0,3086
401,108,,,5,,國會圖書業務,34040010500,0,25704,0,0,0,25704,0,24657,0,0,24657,50361
401,108,,,6,,公報業務,34040010600,0,121393,0,0,0,121393,0,0,0,0,0,121393
401,108,,,7,,黨團補助,34040010700,0,0,13560,0,0,13560,0,0,0,0,0,13560
401,108,,,8,,一般建築及設備,34040019000,0,0,0,0,0,0,0,144468,0,0,144468,144468
401,108,,,,2,營建工程,34040019002,0,0,0,0,0,0,0,22400,0,0,22400,22400
401,108,,,,3,交通及運輸設備,34040019011,0,0,0,0,0,0,0,7840,0,0,7840,7840
401,108,,,,4,其他設備,34040019019,0,0,0,0,0,0,0,114228,0,0,114228,114228
401,108,,,9,,第一預備金,34040019800,0,0,0,0,3000,3000,0,0,0,0,0,3000
401,109,3,,,,立法院主管,00040000000,,,,,,,,,,,,
401,109,,1,,,立法院,00040010000,2482425,809318,14757,0,3000,3309500,0,226963,0,0,226963,3536463
401,109,,,,,立法支出,33040010000,2482425,809318,14757,0,3000,3309500,0,226963,0,0,226963,3536463
401,109,,,1,,一般行政,33040010100,1297246,410231,1197,0,0,1708674,0,29886,0,0,29886,1738560
401,109,,,2,,委員問政業務,33040010200,1185179,237570,0,0,0,1422749,0,0,0,0,0,1422749
401,109,,,,1,委員歲費及公費,33040010201,301668,0,0,0,0,301668,0,0,0,0,0,301668
401,109,,,,2,公費助理,33040010203,796184,0,0,0,0,796184,0,0,0,0,0,796184
401,109,,,,3,國會交流事務,33040010204,0,42600,0,0,0,42600,0,0,0,0,0,42600
401,109,,,,4,委員會館,33040010205,0,132946,0,0,0,132946,0,0,0,0,0,132946
401,109,,,,5,問政相關業務,33040010206,87327,62024,0,0,0,149351,0,0,0,0,0,149351
401,109,,,3,,議事業務,33040010300,0,11126,0,0,0,11126,0,0,0,0,0,11126
401,109,,,4,,立法諮詢業務,33040010400,0,2050,0,0,0,2050,0,0,0,0,0,2050
401,109,,,5,,國會圖書業務,33040010500,0,25673,0,0,0,25673,0,26626,0,0,26626,52299
401,109,,,6,,公報業務,33040010600,0,122668,0,0,0,122668,0,0,0,0,0,122668
401,109,,,7,,黨團補助,33040010700,0,0,13560,0,0,13560,0,0,0,0,0,13560
401,109,,,8,,一般建築及設備,33040019000,0,0,0,0,0,0,0,170451,0,0,170451,170451
401,109,,,,1,營建工程,33040019002,0,0,0,0,0,0,0,23500,0,0,23500,23500
401,109,,,,2,交通及運輸設備,33040019011,0,0,0,0,0,0,0,10570,0,0,10570,10570
401,109,,,,3,其他設備,33040019019,0,0,0,0,0,0,0,136381,0,0,136381,136381
401,109,,,9,,第一預備金,33040019800,0,0,0,0,3000,3000,0,0,0,0,0,3000
401,110,3,,,,立法院主管,00040000000,,,,,,,,,,,,
401,110,,1,,,立法院,00040010000,2455731,751043,15208,0,3000,3224982,0,199627,0,0,199627,3424609
401,110,,,,,立法支出,33040010000,2455731,751043,15208,0,3000,3224982,0,199627,0,0,199627,3424609
401,110,,,1,,一般行政,33040010100,1273318,395355,1648,0,0,1670321,0,30086,0,0,30086,1700407
401,110,,,2,,委員問政業務,33040010200,1182413,190882,0,0,0,1373295,0,0,0,0,0,1373295
401,110,,,,1,委員歲費及公費,33040010201,301668,0,0,0,0,301668,0,0,0,0,0,301668
401,110,,,,2,公費助理,33040010203,796184,0,0,0,0,796184,0,0,0,0,0,796184
401,110,,,,3,國會交流事務,33040010204,0,42600,0,0,0,42600,0,0,0,0,0,42600
401,110,,,,4,委員會館,33040010205,0,94086,0,0,0,94086,0,0,0,0,0,94086
401,110,,,,5,問政相關業務,33040010206,84561,54196,0,0,0,138757,0,0,0,0,0,138757
401,110,,,3,,議事業務,33040010300,0,11148,0,0,0,11148,0,0,0,0,0,11148
401,110,,,4,,立法諮詢業務,33040010400,0,1650,0,0,0,1650,0,0,0,0,0,1650
401,110,,,5,,國會圖書業務,33040010500,0,24875,0,0,0,24875,0,22234,0,0,22234,47109
401,110,,,6,,公報業務,33040010600,0,127133,0,0,0,127133,0,0,0,0,0,127133
401,110,,,7,,黨團補助,33040010700,0,0,13560,0,0,13560,0,0,0,0,0,13560
401,110,,,8,,一般建築及設備,33040019000,0,0,0,0,0,0,0,147307,0,0,147307,147307
401,110,,,,1,營建工程,33040019002,0,0,0,0,0,0,0,5900,0,0,5900,5900
401,110,,,,2,交通及運輸設備,33040019011,0,0,0,0,0,0,0,13170,0,0,13170,13170
401,110,,,,3,其他設備,33040019019,0,0,0,0,0,0,0,128237,0,0,128237,128237
401,110,,,9,,第一預備金,33040019800,0,0,0,0,3000,3000,0,0,0,0,0,3000
401,111,3,,,,立法院主管,00040000000,,,,,,,,,,,,
401,111,,1,,,立法院,00040010000,2460180,755512,15550,0,3000,3234242,0,215770,0,0,215770,3450012
401,111,,,,,立法支出,33040010000,2460180,755512,15550,0,3000,3234242,0,215770,0,0,215770,3450012
401,111,,,1,,一般行政,33040010100,1274188,406936,1690,0,0,1682814,0,20439,0,0,20439,1703253
401,111,,,2,,委員問政業務,33040010200,1185992,188248,0,0,0,1374240,0,0,0,0,0,1374240
401,111,,,,1,委員歲費及公費,33040010201,301668,0,0,0,0,301668,0,0,0,0,0,301668
401,111,,,,2,公費助理,33040010203,796184,0,0,0,0,796184,0,0,0,0,0,796184
401,111,,,,3,國會交流事務,33040010204,0,42600,0,0,0,42600,0,0,0,0,0,42600
401,111,,,,4,委員會館,33040010205,0,91452,0,0,0,91452,0,0,0,0,0,91452
401,111,,,,5,問政相關業務,33040010206,88140,54196,0,0,0,142336,0,0,0,0,0,142336
401,111,,,3,,議事業務,33040010300,0,11103,0,0,0,11103,0,0,0,0,0,11103
401,111,,,4,,立法諮詢業務,33040010400,0,1350,0,0,0,1350,0,0,0,0,0,1350
401,111,,,5,,國會圖書業務,33040010500,0,23840,300,0,0,24140,0,22678,0,0,22678,46818
401,111,,,6,,公報業務,33040010600,0,124035,0,0,0,124035,0,0,0,0,0,124035
401,111,,,7,,黨團補助,33040010700,0,0,13560,0,0,13560,0,0,0,0,0,13560
401,111,,,8,,一般建築及設備,33040019000,0,0,0,0,0,0,0,172653,0,0,172653,172653
401,111,,,,1,營建工程,33040019002,0,0,0,0,0,0,0,45486,0,0,45486,45486
401,111,,,,2,交通及運輸設備,33040019011,0,0,0,0,0,0,0,8450,0,0,8450,8450
401,111,,,,3,其他設備,33040019019,0,0,0,0,0,0,0,118717,0,0,118717,118717
401,111,,,9,,第一預備金,33040019800,0,0,0,0,3000,3000,0,0,0,0,0,3000
401,112,3,,,,立法院主管,00040000000,,,,,,,,,,,,
401,112,,1,,,立法院,00040010000,2555081,759968,15699,0,3000,3333748,0,301217,0,0,301217,3634965
401,112,,,,,立法支出,33040010000,2555081,759968,15699,0,3000,3333748,0,301217,0,0,301217,3634965
401,112,,,1,,一般行政,33040010100,1323884,411019,1839,0,0,1736742,0,23853,0,0,23853,1760595
401,112,,,2,,委員問政業務,33040010200,1231197,190357,0,0,0,1421554,0,0,0,0,0,1421554
401,112,,,,1,委員歲費及公費,33040010201,313963,0,0,0,0,313963,0,0,0,0,0,313963
401,112,,,,2,公費助理,33040010203,828036,0,0,0,0,828036,0,0,0,0,0,828036
401,112,,,,3,國會交流事務,33040010204,0,42600,0,0,0,42600,0,0,0,0,0,42600
401,112,,,,4,委員會館,33040010205,0,93561,0,0,0,93561,0,0,0,0,0,93561
401,112,,,,5,問政相關業務,33040010206,89198,54196,0,0,0,143394,0,0,0,0,0,143394
401,112,,,3,,議事業務,33040010300,0,10912,0,0,0,10912,0,0,0,0,0,10912
401,112,,,4,,立法諮詢業務,33040010400,0,1100,0,0,0,1100,0,0,0,0,0,1100
401,112,,,5,,國會圖書業務,33040010500,0,23007,300,0,0,23307,0,22819,0,0,22819,46126
401,112,,,6,,公報業務,33040010600,0,123573,0,0,0,123573,0,0,0,0,0,123573
401,112,,,7,,黨團補助,33040010700,0,0,13560,0,0,13560,0,0,0,0,0,13560
401,112,,,8,,一般建築及設備,33040019000,0,0,0,0,0,0,0,254545,0,0,254545,254545
401,112,,,,1,營建工程,33040019002,0,0,0,0,0,0,0,143990,0,0,143990,143990
401,112,,,,2,交通及運輸設備,33040019011,0,0,0,0,0,0,0,2760,0,0,2760,2760
401,112,,,,3,其他設備,33040019019,0,0,0,0,0,0,0,107795,0,0,107795,107795
401,112,,,9,,第一預備金,33040019800,0,0,0,0,3000,3000,0,0,0,0,0,3000
401,113,3,,,,立法院主管,00040000000,,,,,,,,,,,,
401,113,,1,,,立法院,00040010000,2582545,828400,15699,0,3000,3429644,0,238977,0,0,238977,3668621
401,113,,,,,立法支出,33040010000,2582545,828400,15699,0,3000,3429644,0,238977,0,0,238977,3668621
401,113,,,1,,一般行政,33040010100,1351917,437312,1839,0,0,1791068,0,30222,0,0,30222,1821290
401,113,,,2,,委員問政業務,33040010200,1230628,230421,0,0,0,1461049,0,0,0,0,0,1461049
401,113,,,,1,委員歲費及公費,33040010201,313963,0,0,0,0,313963,0,0,0,0,0,313963
401,113,,,,2,公費助理,33040010203,828036,0,0,0,0,828036,0,0,0,0,0,828036
401,113,,,,3,國會交流事務,33040010204,0,42600,0,0,0,42600,0,0,0,0,0,42600
401,113,,,,4,委員會館,33040010205,0,127297,0,0,0,127297,0,0,0,0,0,127297
401,113,,,,5,問政相關業務,33040010206,88629,60524,0,0,0,149153,0,0,0,0,0,149153
401,113,,,3,,議事業務,33040010300,0,11112,0,0,0,11112,0,0,0,0,0,11112
401,113,,,4,,立法諮詢業務,33040010400,0,1100,0,0,0,1100,0,0,0,0,0,1100
401,113,,,5,,國會圖書業務,33040010500,0,20968,300,0,0,21268,0,23333,0,0,23333,44601
401,113,,,6,,公報業務,33040010600,0,127487,0,0,0,127487,0,0,0,0,0,127487
401,113,,,7,,黨團補助,33040010700,0,0,13560,0,0,13560,0,0,0,0,0,13560
401,113,,,8,,一般建築及設備,33040019000,0,0,0,0,0,0,0,185422,0,0,185422,185422
401,113,,,,1,營建工程,33040019002,0,0,0,0,0,0,0,54631,0,0,54631,54631
401,113,,,,2,交通及運輸設備,33040019011,0,0,0,0,0,0,0,6300,0,0,6300,6300
401,113,,,,3,其他設備,33040019019,0,0,0,0,0,0,0,124491,0,0,124491,124491
401,113,,,9,,第一預備金,33040019800,0,0,0,0,3000,3000,0,0,0,0,0,3000
501,110,4,,,,司法院主管,00050000000,,,,,,,,,,,,
501,110,,1,,,司法院,00050010000,979281,668711,1493593,0,3000,3144585,0,589088,23942,0,613030,3757615
501,110,,,,,司法支出,34050010000,591228,668711,35038,0,3000,1297977,0,589088,519,0,589607,1887584
501,110,,,1,,一般行政,34050010100,591228,415302,482,0,0,1007012,0,374417,0,0,374417,1381429
501,110,,,2,,大法官釋憲業務,34050011000,0,6128,0,0,0,6128,0,0,0,0,0,6128
501,110,,,3,,審判行政,34050011300,0,212921,32804,0,0,245725,0,208771,519,0,209290,455015
501,110,,,4,,司法業務規劃研考,34050011700,0,34360,1752,0,0,36112,0,0,0,0,0,36112
501,110,,,5,,一般建築及設備,34050019000,0,0,0,0,0,0,0,5900,0,0,5900,5900
501,110,,,,1,交通及運輸設備,34050019011,0,0,0,0,0,0,0,5900,0,0,5900,5900
501,110,,,6,,第一預備金,34050019800,0,0,0,0,3000,3000,0,0,0,0,0,3000
501,110,,,,,福利服務支出,63050010000,0,0,1458555,0,0,1458555,0,0,23423,0,23423,1481978
501,110,,,7,,對財團法人法律扶助基金會捐助,63050011900,0,0,1458555,0,0,1458555,0,0,23423,0,23423,1481978
501,110,,,,,退休撫卹給付支出,76050010000,388053,0,0,0,0,388053,0,0,0,0,0,388053
501,110,,,8,,司法官退休退養給付,76050011900,388053,0,0,0,0,388053,0,0,0,0,0,388053
501,111,4,,,,司法院主管,00050000000,,,,,,,,,,,,
501,111,,1,,,司法院,00050010000,1075616,620347,1450033,0,3000,3148996,0,480734,23742,0,504476,3653472
501,111,,,,,司法支出,34050010000,608634,620347,39097,0,3000,1271078,0,480734,517,0,481251,1752329
501,111,,,1,,一般行政,34050010100,608634,479124,512,0,0,1088270,0,480734,0,0,480734,1569004
501,111,,,2,,憲法訴訟業務,34050011000,0,14628,0,0,0,14628,0,0,0,0,0,14628
501,111,,,3,,審判行政,34050011300,0,99658,32775,0,0,132433,0,0,517,0,517,132950
501,111,,,4,,司法業務規劃研考,34050011700,0,26937,5810,0,0,32747,0,0,0,0,0,32747
501,111,,,6,,第一預備金,34050019800,0,0,0,0,3000,3000,0,0,0,0,0,3000
501,111,,,,,福利服務支出,63050010000,0,0,1410936,0,0,1410936,0,0,23225,0,23225,1434161
501,111,,,7,,對財團法人法律扶助基金會捐助,63050011900,0,0,1410936,0,0,1410936,0,0,23225,0,23225,1434161
501,111,,,,,退休撫卹給付支出,76050010000,466982,0,0,0,0,466982,0,0,0,0,0,466982
501,111,,,8,,司法官退休退養給付,76050011900,466982,0,0,0,0,466982,0,0,0,0,0,466982
501,112,4,,,,司法院主管,00050000000,,,,,,,,,,,,
501,112,,1,,,司法院,00050010000,1203369,594713,1385559,0,3000,3186641,0,479638,37991,0,517629,3704270
501,112,,,,,司法支出,34050010000,644793,594713,51600,0,3000,1294106,0,479638,742,0,480380,1774486
501,112,,,1,,一般行政,34050010100,644793,484299,518,0,0,1129610,0,474298,0,0,474298,1603908
501,112,,,2,,憲法訴訟業務,34050011000,0,12103,0,0,0,12103,0,0,0,0,0,12103
501,112,,,3,,審判行政,34050011300,0,87486,32755,0,0,120241,0,0,532,0,532,120773
501,112,,,4,,司法業務規劃研考,34050011700,0,10825,18327,0,0,29152,0,0,210,0,210,29362
501,112,,,5,,一般建築及設備,34050019000,0,0,0,0,0,0,0,5340,0,0,5340,5340
501,112,,,,1,交通及運輸設備,34050019011,0,0,0,0,0,0,0,5340,0,0,5340,5340
501,112,,,6,,第一預備金,34050019800,0,0,0,0,3000,3000,0,0,0,0,0,3000
501,112,,,,,福利服務支出,63050010000,0,0,1333959,0,0,1333959,0,0,37249,0,37249,1371208
501,112,,,7,,對財團法人法律扶助基金會捐助,63050011900,0,0,1333959,0,0,1333959,0,0,37249,0,37249,1371208
501,112,,,,,退休撫卹給付支出,76050010000,558576,0,0,0,0,558576,0,0,0,0,0,558576
501,112,,,8,,司法官退休退養給付,76050011900,558576,0,0,0,0,558576,0,0,0,0,0,558576
501,110,4,,,,司法院主管,00050000000,,,,,,,,,,,,
501,110,,1,,,司法院,00050010000,979281,725821,1543600,0,3000,3251702,0,626689,43983,0,670672,3922374
501,110,,,,,司法支出,34050010000,591228,725821,35202,0,3000,1355251,0,626689,560,0,627249,1982500
501,110,,,1,,一般行政,34050010100,591228,418492,482,0,0,1010202,0,402959,0,0,402959,1413161
501,110,,,2,,大法官釋憲業務,34050011000,0,6128,0,0,0,6128,0,0,0,0,0,6128
501,110,,,3,,審判行政,34050011300,0,265841,32876,0,0,298717,0,217830,560,0,218390,517107
501,110,,,4,,司法業務規劃研考,34050011700,0,35360,1844,0,0,37204,0,0,0,0,0,37204
501,110,,,5,,一般建築及設備,34050019000,0,0,0,0,0,0,0,5900,0,0,5900,5900
501,110,,,,1,交通及運輸設備,34050019011,0,0,0,0,0,0,0,5900,0,0,5900,5900
501,110,,,6,,第一預備金,34050019800,0,0,0,0,3000,3000,0,0,0,0,0,3000
501,110,,,,,福利服務支出,63050010000,0,0,1508398,0,0,1508398,0,0,43423,0,43423,1551821
501,110,,,7,,對財團法人法律扶助基金會捐助,63050011900,0,0,1508398,0,0,1508398,0,0,43423,0,43423,1551821
501,110,,,,,退休撫卹給付支出,76050010000,388053,0,0,0,0,388053,0,0,0,0,0,388053
501,110,,,8,,司法官退休退養給付,76050011900,388053,0,0,0,0,388053,0,0,0,0,0,388053
501,111,4,,,,司法院主管,00050000000,,,,,,,,,,,,
501,111,,1,,,司法院,00050010000,1075616,653229,1511796,0,3000,3243641,0,507673,38785,0,546458,3790099
501,111,,,,,司法支出,34050010000,608634,653229,39471,0,3000,1304334,0,507673,560,0,508233,1812567
501,111,,,1,,一般行政,34050010100,608634,506499,512,0,0,1115645,0,507673,0,0,507673,1623318
501,111,,,2,,憲法訴訟業務,34050011000,0,14688,0,0,0,14688,0,0,0,0,0,14688
501,111,,,3,,審判行政,34050011300,0,100305,32844,0,0,133149,0,0,560,0,560,133709
501,111,,,4,,司法業務規劃研考,34050011700,0,31737,6115,0,0,37852,0,0,0,0,0,37852
501,111,,,6,,第一預備金,34050019800,0,0,0,0,3000,3000,0,0,0,0,0,3000
501,111,,,,,福利服務支出,63050010000,0,0,1472325,0,0,1472325,0,0,38225,0,38225,1510550
501,111,,,7,,對財團法人法律扶助基金會捐助,63050011900,0,0,1472325,0,0,1472325,0,0,38225,0,38225,1510550
501,111,,,,,退休撫卹給付支出,76050010000,466982,0,0,0,0,466982,0,0,0,0,0,466982
501,111,,,8,,司法官退休退養給付,76050011900,466982,0,0,0,0,466982,0,0,0,0,0,466982
501,112,4,,,,司法院主管,00050000000,,,,,,,,,,,,
501,112,,1,,,司法院,00050010000,1203369,607229,1459323,0,3000,3272921,0,507469,38019,0,545488,3818409
501,112,,,,,司法支出,34050010000,644793,607229,51766,0,3000,1306788,0,507469,770,0,508239,1815027
501,112,,,1,,一般行政,34050010100,644793,495464,518,0,0,1140775,0,502129,0,0,502129,1642904
501,112,,,2,,憲法訴訟業務,34050011000,0,12440,0,0,0,12440,0,0,0,0,0,12440
501,112,,,3,,審判行政,34050011300,0,88500,32839,0,0,121339,0,0,560,0,560,121899
501,112,,,4,,司法業務規劃研考,34050011700,0,10825,18409,0,0,29234,0,0,210,0,210,29444
501,112,,,5,,一般建築及設備,34050019000,0,0,0,0,0,0,0,5340,0,0,5340,5340
501,112,,,,1,交通及運輸設備,34050019011,0,0,0,0,0,0,0,5340,0,0,5340,5340
501,112,,,6,,第一預備金,34050019800,0,0,0,0,3000,3000,0,0,0,0,0,3000
501,112,,,,,福利服務支出,63050010000,0,0,1407557,0,0,1407557,0,0,37249,0,37249,1444806
501,112,,,7,,對財團法人法律扶助基金會捐助,63050011900,0,0,1407557,0,0,1407557,0,0,37249,0,37249,1444806
501,112,,,,,退休撫卹給付支出,76050010000,558576,0,0,0,0,558576,0,0,0,0,0,558576
501,112,,,8,,司法官退休退養給付,76050011900,558576,0,0,0,0,558576,0,0,0,0,0,558576
501,113,4,,,,司法院主管,00050000000,,,,,,,,,,,,
501,113,,1,,,司法院,00050010000,1240319,754731,1479982,0,3000,3478032,0,436069,54254,0,490323,3968355
501,113,,,,,司法支出,34050010000,641097,754731,38881,0,3000,1437709,0,436069,1260,0,437329,1875038
501,113,,,1,,一般行政,34050010100,641097,639895,542,0,0,1281534,0,428462,0,0,428462,1709996
501,113,,,2,,憲法訴訟業務,34050011000,0,10600,0,0,0,10600,0,0,0,0,0,10600
501,113,,,3,,審判行政,34050011300,0,93801,36756,0,0,130557,0,2227,560,0,2787,133344
501,113,,,4,,司法業務規劃研考,34050011700,0,10435,1583,0,0,12018,0,0,700,0,700,12718
501,113,,,5,,一般建築及設備,34050019000,0,0,0,0,0,0,0,5380,0,0,5380,5380
501,113,,,,1,交通及運輸設備,34050019011,0,0,0,0,0,0,0,5380,0,0,5380,5380
501,113,,,6,,第一預備金,34050019800,0,0,0,0,3000,3000,0,0,0,0,0,3000
501,113,,,,,福利服務支出,63050010000,0,0,1441101,0,0,1441101,0,0,52994,0,52994,1494095
501,113,,,7,,對財團法人法律扶助基金會捐助,63050011900,0,0,1441101,0,0,1441101,0,0,52994,0,52994,1494095
501,113,,,,,退休撫卹給付支出,76050010000,599222,0,0,0,0,599222,0,0,0,0,0,599222
501,113,,,8,,司法官退休退養給付,76050011900,599222,0,0,0,0,599222,0,0,0,0,0,599222
2001,105,11,,,,教育部主管,00200000000,14466008,2495817,94913058,0,466292,112341175,31058,9177904,5606236,0,14815198,127156373
2001,105,,1,,,教育部,00200010000,14466008,2495817,94913058,0,466292,112341175,31058,9177904,5606236,0,14815198,127156373
2001,105,,,,,教育支出,51200010000,622303,2485287,83508542,0,466292,87082424,31058,8862077,5313238,0,14206373,101288797
2001,105,,,1,,一般行政,51200010100,593053,219451,38099,0,0,850603,4472,6388,1700,0,12560,863163
2001,105,,,2,,高等教育,51200010200,0,531875,77575958,0,0,78107833,426,2966419,4906340,0,7873185,85981018
2001,105,,,,1,高等教育行政及督導,51200010201,0,198710,7702202,0,0,7900912,426,1975884,334818,0,2311128,10212040
2001,105,,,,2,技術職業教育行政及督導,51200010202,0,279370,4186266,0,0,4465636,0,990535,1298136,0,2288671,6754307
2001,105,,,,3,國立大學校院教學與研究輔助,51200010203,0,0,42391310,0,0,42391310,0,0,0,0,0,42391310
2001,105,,,,4,私立學校教學獎助,51200010204,0,53795,23296180,0,0,23349975,0,0,3273386,0,3273386,26623361
2001,105,,,3,,中等教育,51200010300,0,457366,479126,0,0,936492,11950,20230,38780,0,70960,1007452
2001,105,,,,1,師資培育與藝術教育行政及督導,51200010301,0,457366,479126,0,0,936492,11950,20230,38780,0,70960,1007452
2001,105,,,4,,終身教育,51200010500,29250,204876,681818,0,0,915944,3300,77067,38795,0,119162,1035106
2001,105,,,,1,終身教育行政及督導,51200010501,0,162875,678732,0,0,841607,3300,76104,38795,0,118199,959806
2001,105,,,,2,國立臺灣藝術教育館行政及推展,51200010507,29250,42001,3086,0,0,74337,0,963,0,0,963,75300
2001,105,,,5,,訓育與輔導,51200010700,0,247419,1806142,0,0,2053561,9650,66435,88800,0,164885,2218446
2001,105,,,,1,學生事務與特殊教育行政及督導,51200010701,0,247419,1806142,0,0,2053561,9650,66435,88800,0,164885,2218446
2001,105,,,6,,各項教育推展,51200010900,0,824300,2927399,0,0,3751699,1260,196586,238823,0,436669,4188368
2001,105,,,,1,資訊與科技教育行政及督導,51200010904,0,668556,1338083,0,0,2006639,0,196586,237523,0,434109,2440748
2001,105,,,,2,國際及兩岸教育交流,51200010908,0,155744,1589316,0,0,1745060,1260,0,1300,0,2560,1747620
2001,105,,,7,,非營業特種基金,51200018100,0,0,0,0,0,0,0,5528952,0,0,5528952,5528952
2001,105,,,,1,國立大學校院校務及附設醫院基金,51200018110,0,0,0,0,0,0,0,5528952,0,0,5528952,5528952
2001,105,,,9,,第一預備金,51200019800,0,0,0,0,466292,466292,0,0,0,0,0,466292
2001,105,,,,,文化支出,53200010000,0,10530,1317263,0,0,1327793,0,315827,292998,0,608825,1936618
2001,105,,,10,,加強文化與育樂活動,53200011100,0,10530,1317263,0,0,1327793,0,313502,292998,0,606500,1934293
2001,105,,,,1,充實國立社教機構及公立圖書館功能,53200011101,0,10530,161716,0,0,172246,0,313502,292998,0,606500,778746
2001,105,,,,2,國立社教館所維持及發展輔助,53200011103,0,0,1155547,0,0,1155547,0,0,0,0,0,1155547
2001,105,,,11,,非營業特種基金,53200018100,0,0,0,0,0,0,0,2325,0,0,2325,2325
2001,105,,,,1,國立社教機構作業基金,53200018110,0,0,0,0,0,0,0,2325,0,0,2325,2325
2001,105,,,,,退休撫卹給付支出,75200010000,13843705,0,10087253,0,0,23930958,0,0,0,0,0,23930958
2001,105,,,12,,學校教職員暨社教機構聘任人員退休撫卹給付,75200012100,13843705,0,10087253,0,0,23930958,0,0,0,0,0,23930958
2001,106,11,,,,教育部主管,00200000000,16013997,2546305,95717877,0,466292,114744471,37912,10831824,8024704,0,18894440,133638911
2001,106,,1,,,教育部,00200010000,16013997,2546305,95717877,0,466292,114744471,37912,10831824,8024704,0,18894440,133638911
2001,106,,,,,教育支出,51200010000,596228,2546305,88499258,0,466292,92108083,37912,10335697,7906765,0,18280374,110388457
2001,106,,,1,,一般行政,51200010100,567552,232782,132009,0,0,932343,7904,52955,1300,0,62159,994502
2001,106,,,2,,高等教育,51200010200,0,572127,81760486,0,0,82332613,5426,3097724,7407013,0,10510163,92842776
2001,106,,,,1,高等教育行政及督導,51200010201,0,195584,9365691,0,0,9561275,426,2020250,506838,0,2527514,12088789
2001,106,,,,2,技術職業教育行政及督導,51200010202,0,317274,5083499,0,0,5400773,5000,1077474,1136018,0,2218492,7619265
2001,106,,,,3,國立大學校院教學與研究輔助,51200010203,0,0,42350295,0,0,42350295,0,0,0,0,0,42350295
2001,106,,,,4,私立學校教學獎助,51200010204,0,59269,24961001,0,0,25020270,0,0,5764157,0,5764157,30784427
2001,106,,,3,,中等教育,51200010300,0,525234,686926,0,0,1212160,12950,21730,47280,0,81960,1294120
2001,106,,,,1,師資培育與藝術教育行政及督導,51200010301,0,525234,686926,0,0,1212160,12950,21730,47280,0,81960,1294120
2001,106,,,4,,終身教育,51200010500,28676,237022,1042408,0,0,1308106,400,131526,123881,0,255807,1563913
2001,106,,,,1,終身教育行政及督導,51200010501,0,191722,1039385,0,0,1231107,400,130411,123881,0,254692,1485799
2001,106,,,,2,國立臺灣藝術教育館行政及推展,51200010507,28676,45300,3023,0,0,76999,0,1115,0,0,1115,78114
2001,106,,,5,,學務與輔導,51200010700,0,236862,1588721,0,0,1825583,8650,62535,91500,0,162685,1988268
2001,106,,,,1,學生事務與特殊教育行政及督導,51200010701,0,236862,1588721,0,0,1825583,8650,62535,91500,0,162685,1988268
2001,106,,,6,,各項教育推展,51200010900,0,742278,3288708,0,0,4030986,2582,178023,235791,0,416396,4447382
2001,106,,,,1,資訊與科技教育行政及督導,51200010904,0,606599,1451159,0,0,2057758,0,170023,234491,0,404514,2462272
2001,106,,,,2,國際及兩岸教育交流,51200010908,0,135679,1837549,0,0,1973228,2582,8000,1300,0,11882,1985110
2001,106,,,7,,非營業特種基金,51200018100,0,0,0,0,0,0,0,6791204,0,0,6791204,6791204
2001,106,,,,1,國立大學校院校務及附設醫院基金,51200018110,0,0,0,0,0,0,0,4291204,0,0,4291204,4291204
2001,106,,,,2,大專校院轉型及退場基金,51200018120,0,0,0,0,0,0,0,2500000,0,0,2500000,2500000
2001,106,,,8,,第一預備金,51200019800,0,0,0,0,466292,466292,0,0,0,0,0,466292
2001,106,,,,,文化支出,53200010000,0,0,1253244,0,0,1253244,0,496127,117939,0,614066,1867310
2001,106,,,9,,加強文化與育樂活動,53200011100,0,0,1253244,0,0,1253244,0,490261,117939,0,608200,1861444
2001,106,,,,1,創新國立社教機構前瞻發展,53200011101,0,0,101238,0,0,101238,0,490261,117939,0,608200,709438
2001,106,,,,2,國立社教館所維持及發展輔助,53200011103,0,0,1152006,0,0,1152006,0,0,0,0,0,1152006
2001,106,,,10,,非營業特種基金,53200018100,0,0,0,0,0,0,0,5866,0,0,5866,5866
2001,106,,,,1,國立社教機構作業基金,53200018110,0,0,0,0,0,0,0,5866,0,0,5866,5866
2001,106,,,,,退休撫卹給付支出,75200010000,15417769,0,5965375,0,0,21383144,0,0,0,0,0,21383144
2001,106,,,11,,學校教職員暨社教機構聘任人員退休撫卹給付,75200012100,15417769,0,5965375,0,0,21383144,0,0,0,0,0,21383144
2001,107,11,,,,教育部主管,00200000000,15807360,2517406,100469890,0,466292,119260948,45082,7191659,5931298,0,13168039,132428987
2001,107,,1,,,教育部,00200010000,15807360,2517406,100469890,0,466292,119260948,45082,7191659,5931298,0,13168039,132428987
2001,107,,,,,教育支出,51200010000,596533,2517406,92916798,0,466292,96497029,45082,7093719,5912536,0,13051337,109548366
2001,107,,,1,,一般行政,51200010100,567552,217819,233052,0,0,1018423,5501,5074,1300,0,11875,1030298
2001,107,,,2,,高等教育,51200010200,0,608792,85854370,0,0,86463162,14674,1909037,5386719,0,7310430,93773592
2001,107,,,,1,高等教育行政及督導,51200010201,0,243579,11677435,0,0,11921014,5674,1526975,801542,0,2334191,14255205
2001,107,,,,2,技術職業教育行政及督導,51200010202,0,303802,7044936,0,0,7348738,9000,382062,683361,0,1074423,8423161
2001,107,,,,3,國立大學校院教學與研究輔助,51200010203,0,0,44702055,0,0,44702055,0,0,0,0,0,44702055
2001,107,,,,4,私立學校教學獎助,51200010204,0,61411,22429944,0,0,22491355,0,0,3901816,0,3901816,26393171
2001,107,,,3,,中等教育,51200010300,0,434325,839487,0,0,1273812,10190,23045,79903,0,113138,1386950
2001,107,,,,1,師資培育與藝術教育行政及督導,51200010301,0,434325,839487,0,0,1273812,10190,23045,79903,0,113138,1386950
2001,107,,,4,,終身教育,51200010500,28981,254107,1127333,0,0,1410421,470,273083,172828,0,446381,1856802
2001,107,,,,1,終身教育行政及督導,51200010501,0,206395,1124310,0,0,1330705,470,263159,172828,0,436457,1767162
2001,107,,,,2,國立臺灣藝術教育館行政及推展,51200010507,28981,47712,3023,0,0,79716,0,9924,0,0,9924,89640
2001,107,,,5,,學務與輔導,51200010700,0,255878,1577682,0,0,1833560,10621,54115,101407,0,166143,1999703
2001,107,,,,1,學生事務與特殊教育行政及督導,51200010701,0,255878,1577682,0,0,1833560,10621,54115,101407,0,166143,1999703
2001,107,,,6,,各項教育推展,51200010900,0,746485,3284874,0,0,4031359,3626,134527,170379,0,308532,4339891
2001,107,,,,1,資訊與科技教育行政及督導,51200010904,0,608391,1446718,0,0,2055109,654,132214,169979,0,302847,2357956
2001,107,,,,2,國際及兩岸教育交流,51200010908,0,138094,1838156,0,0,1976250,2972,2313,400,0,5685,1981935
2001,107,,,7,,非營業特種基金,51200018100,0,0,0,0,0,0,0,4694838,0,0,4694838,4694838
2001,107,,,,1,國立大學校院校務及附設醫院基金,51200018110,0,0,0,0,0,0,0,3877638,0,0,3877638,3877638
2001,107,,,,2,大專校院轉型及退場基金,51200018120,0,0,0,0,0,0,0,817200,0,0,817200,817200
2001,107,,,8,,第一預備金,51200019800,0,0,0,0,466292,466292,0,0,0,0,0,466292
2001,107,,,,,文化支出,53200010000,0,0,1209201,0,0,1209201,0,97940,18762,0,116702,1325903
2001,107,,,9,,加強文化與育樂活動,53200011100,0,0,1209201,0,0,1209201,0,94934,18762,0,113696,1322897
2001,107,,,,1,國立社教機構創新與發展,53200011101,0,0,36250,0,0,36250,0,94934,18762,0,113696,149946
2001,107,,,,2,國立社教館所維持及發展輔助,53200011103,0,0,1172951,0,0,1172951,0,0,0,0,0,1172951
2001,107,,,10,,非營業特種基金,53200018100,0,0,0,0,0,0,0,3006,0,0,3006,3006
2001,107,,,,1,國立社教機構作業基金,53200018110,0,0,0,0,0,0,0,3006,0,0,3006,3006
2001,107,,,,,退休撫卹給付支出,75200010000,15210827,0,6343891,0,0,21554718,0,0,0,0,0,21554718
2001,107,,,11,,學校教職員暨社教機構聘任人員退休撫卹給付,75200012100,15210827,0,6343891,0,0,21554718,0,0,0,0,0,21554718
2001,109,11,,,,教育部主管,00200000000,,,,,,,,,,,,
2001,109,,1,,,教育部,00200010000,13013927,2820578,101483139,0,466292,117783936,97054,7192750,6025243,0,13315047,131098983
2001,109,,,,,教育支出,51200010000,639038,2820578,94910629,0,466292,98836537,97054,7081247,5985562,0,13163863,112000400
2001,109,,,1,,一般行政,51200010100,609294,242667,198472,0,0,1050433,1000,12914,724,0,14638,1065071
2001,109,,,2,,高等教育,51200010200,0,736689,87605347,0,0,88342036,26280,2874463,5016342,0,7917085,96259121
2001,109,,,,1,高等教育行政及督導,51200010201,0,305459,12415356,0,0,12720815,11280,2161275,1301737,0,3474292,16195107
2001,109,,,,2,技術職業教育行政及督導,51200010202,0,369673,6851867,0,0,7221540,15000,713188,673524,0,1401712,8623252
2001,109,,,,3,國立大學校院教學與研究輔助,51200010203,0,0,45839733,0,0,45839733,0,0,0,0,0,45839733
2001,109,,,,4,私立學校教學獎助,51200010204,0,61557,22498391,0,0,22559948,0,0,3041081,0,3041081,25601029
2001,109,,,3,,中等教育,51200010300,0,551605,813963,0,0,1365568,22914,19543,67620,0,110077,1475645
2001,109,,,,1,師資培育與藝術教育行政及督導,51200010301,0,551605,813963,0,0,1365568,22914,19543,67620,0,110077,1475645
2001,109,,,4,,終身教育,51200010500,29744,345889,1240148,0,0,1615781,29870,141249,692129,0,863248,2479029
2001,109,,,,1,終身教育行政及督導,51200010501,0,291253,1237110,0,0,1528363,29870,140699,692129,0,862698,2391061
2001,109,,,,2,國立臺灣藝術教育館行政及推展,51200010507,29744,54636,3038,0,0,87418,0,550,0,0,550,87968
2001,109,,,5,,學務與輔導,51200010700,0,267686,1512547,0,0,1780233,12600,50088,57997,0,120685,1900918
2001,109,,,,1,學生事務與特殊教育行政及督導,51200010701,0,267686,1512547,0,0,1780233,12600,50088,57997,0,120685,1900918
2001,109,,,6,,各項教育推展,51200010900,0,676042,3540152,0,0,4216194,4390,105728,150750,0,260868,4477062
2001,109,,,,1,資訊與科技教育行政及督導,51200010904,0,558642,1363737,0,0,1922379,900,105164,150350,0,256414,2178793
2001,109,,,,2,國際及兩岸教育交流,51200010908,0,117400,2176415,0,0,2293815,3490,564,400,0,4454,2298269
2001,109,,,7,,非營業特種基金,51200018100,0,0,0,0,0,0,0,3877262,0,0,3877262,3877262
2001,109,,,,1,國立大學校院校務及附設醫院基金,51200018110,0,0,0,0,0,0,0,3877262,0,0,3877262,3877262
2001,109,,,9,,第一預備金,51200019800,0,0,0,0,466292,466292,0,0,0,0,0,466292
2001,109,,,,,文化支出,53200010000,0,0,1206693,0,0,1206693,0,111503,39681,0,151184,1357877
2001,109,,,10,,加強文化與育樂活動,53200011100,0,0,1206693,0,0,1206693,0,111503,39681,0,151184,1357877
2001,109,,,,1,國立社教機構創新與發展,53200011101,0,0,30736,0,0,30736,0,111503,39681,0,151184,181920
2001,109,,,,2,教育部所屬機構維持及發展輔助,53200011103,0,0,1175957,0,0,1175957,0,0,0,0,0,1175957
2001,109,,,,,退休撫卹給付支出,76200010000,12374889,0,5365817,0,0,17740706,0,0,0,0,0,17740706
2001,109,,,11,,學校教職員暨社教機構聘任人員退休撫卹給付,76200012100,12374889,0,5365817,0,0,17740706,0,0,0,0,0,17740706
2001,110,11,,,,教育部主管,00200000000,,,,,,,,,,,,
2001,110,,1,,,教育部,00200010000,14512922,2744912,100680525,0,466292,118404651,115215,7774537,5858687,0,13748439,132153090
2001,110,,,,,教育支出,51200010000,708399,2744912,94308844,0,466292,98228447,115215,7528144,5805534,0,13448893,111677340
2001,110,,,1,,一般行政,51200010100,676547,235959,203640,0,0,1116146,1000,18238,1301,0,20539,1136685
2001,110,,,2,,高等教育,51200010200,0,699469,87055647,0,0,87755116,48620,3164743,4910541,0,8123904,95879020
2001,110,,,,1,高等教育行政及督導,51200010201,0,302529,12326720,0,0,12629249,14280,2050374,1301737,0,3366391,15995640
2001,110,,,,2,技術職業教育行政及督導,51200010202,0,337585,6583978,0,0,6921563,34340,1114369,573124,0,1721833,8643396
2001,110,,,,3,國立大學校院教學與研究輔助,51200010203,0,0,45953051,0,0,45953051,0,0,0,0,0,45953051
2001,110,,,,4,私立學校教學獎助,51200010204,0,59355,22191898,0,0,22251253,0,0,3035680,0,3035680,25286933
2001,110,,,3,,中等教育,51200010300,0,544923,747443,0,0,1292366,22384,20646,80720,0,123750,1416116
2001,110,,,,1,師資培育與藝術教育行政及督導,51200010301,0,544923,747443,0,0,1292366,22384,20646,80720,0,123750,1416116
2001,110,,,4,,終身教育,51200010500,31852,335425,1287180,0,0,1654457,17197,305354,623052,0,945603,2600060
2001,110,,,,1,終身教育行政及督導,51200010501,0,281164,1284142,0,0,1565306,17197,299344,623052,0,939593,2504899
2001,110,,,,2,國立臺灣藝術教育館行政及推展,51200010507,31852,54261,3038,0,0,89151,0,6010,0,0,6010,95161
2001,110,,,5,,學務與輔導,51200010700,0,268768,1585593,0,0,1854361,17124,43222,46650,0,106996,1961357
2001,110,,,,1,學生事務與特殊教育行政及督導,51200010701,0,268768,1585593,0,0,1854361,17124,43222,46650,0,106996,1961357
2001,110,,,6,,各項教育推展,51200010900,0,660368,3429341,0,0,4089709,8890,118025,143270,0,270185,4359894
2001,110,,,,1,資訊與科技教育行政及督導,51200010904,0,535197,1235291,0,0,1770488,400,117496,142870,0,260766,2031254
2001,110,,,,2,國際及兩岸教育交流,51200010908,0,125171,2194050,0,0,2319221,8490,529,400,0,9419,2328640
2001,110,,,7,,非營業特種基金,51200018100,0,0,0,0,0,0,0,3857916,0,0,3857916,3857916
2001,110,,,,1,國立大學校院校務及附設醫院基金,51200018110,0,0,0,0,0,0,0,3857916,0,0,3857916,3857916
2001,110,,,8,,第一預備金,51200019800,0,0,0,0,466292,466292,0,0,0,0,0,466292
2001,110,,,,,文化支出,53200010000,0,0,1094429,0,0,1094429,0,246393,53153,0,299546,1393975
2001,110,,,9,,加強文化與育樂活動,53200011100,0,0,1094429,0,0,1094429,0,246393,53153,0,299546,1393975
2001,110,,,,1,國立社教機構創新與發展,53200011101,0,0,36068,0,0,36068,0,246393,53153,0,299546,335614
2001,110,,,,2,教育部所屬機構維持及發展輔助,53200011103,0,0,1058361,0,0,1058361,0,0,0,0,0,1058361
2001,110,,,,,退休撫卹給付支出,76200010000,13804523,0,5277252,0,0,19081775,0,0,0,0,0,19081775
2001,110,,,10,,學校教職員暨社教機構聘任人員退休撫卹給付,76200012100,13804523,0,5277252,0,0,19081775,0,0,0,0,0,19081775
2001,111,11,,,,教育部主管,00200000000,,,,,,,,,,,,
2001,111,,1,,,教育部,00200010000,14018950,3283117,104273249,0,466292,122041608,91253,7388582,7025213,0,14505048,136546656
2001,111,,,,,教育支出,51200010000,737094,3283117,97540924,0,466292,102027427,91253,7152329,7022542,0,14266124,116293551
2001,111,,,1,,一般行政,51200010100,706547,230431,203411,0,0,1140389,1000,27440,1500,0,29940,1170329
2001,111,,,2,,高等教育,51200010200,0,965207,89168977,0,0,90134184,39781,3396686,4644491,0,8080958,98215142
2001,111,,,,1,高等教育行政及督導,51200010201,0,468920,12397254,0,0,12866174,18744,2175278,902450,0,3096472,15962646
2001,111,,,,2,技術職業教育行政及督導,51200010202,0,436539,6588648,0,0,7025187,20737,1221408,617684,0,1859829,8885016
2001,111,,,,3,國立大學校院教學與研究輔助,51200010203,0,0,47430997,0,0,47430997,0,0,0,0,0,47430997
2001,111,,,,4,私立學校教學獎助,51200010204,0,59748,22752078,0,0,22811826,300,0,3124357,0,3124657,25936483
2001,111,,,3,,中等教育,51200010300,0,512910,937209,0,0,1450119,22384,19389,80720,0,122493,1572612
2001,111,,,,1,師資培育與藝術教育行政及督導,51200010301,0,512910,937209,0,0,1450119,22384,19389,80720,0,122493,1572612
2001,111,,,4,,終身教育,51200010500,30547,401042,1412832,0,0,1844421,1874,363888,456402,0,822164,2666585
2001,111,,,,1,終身教育行政及督導,51200010501,0,345476,1409794,0,0,1755270,1874,362878,456402,0,821154,2576424
2001,111,,,,2,國立臺灣藝術教育館行政及推展,51200010507,30547,55566,3038,0,0,89151,0,1010,0,0,1010,90161
2001,111,,,5,,學務與輔導,51200010700,0,258189,1703469,0,0,1961658,17124,43115,46650,0,106889,2068547
2001,111,,,,1,學生事務與特殊教育行政及督導,51200010701,0,258189,1703469,0,0,1961658,17124,43115,46650,0,106889,2068547
2001,111,,,6,,各項教育推展,51200010900,0,915338,4115026,0,0,5030364,9090,95839,1792779,0,1897708,6928072
2001,111,,,,1,資訊與科技教育行政及督導,51200010904,0,796802,1826039,0,0,2622841,600,93840,1792379,0,1886819,4509660
2001,111,,,,2,國際及兩岸教育交流,51200010908,0,118536,2288987,0,0,2407523,8490,1999,400,0,10889,2418412
2001,111,,,7,,非營業特種基金,51200018100,0,0,0,0,0,0,0,3205972,0,0,3205972,3205972
2001,111,,,,1,國立大學校院校務及附設醫院基金,51200018110,0,0,0,0,0,0,0,3205972,0,0,3205972,3205972
2001,111,,,8,,第一預備金,51200019800,0,0,0,0,466292,466292,0,0,0,0,0,466292
2001,111,,,,,文化支出,53200010000,0,0,1133809,0,0,1133809,0,236253,2671,0,238924,1372733
2001,111,,,9,,加強文化與育樂活動,53200011100,0,0,1133809,0,0,1133809,0,236253,2671,0,238924,1372733
2001,111,,,,1,國立社教機構創新與發展,53200011101,0,0,47858,0,0,47858,0,236253,2671,0,238924,286782
2001,111,,,,2,教育部所屬機構維持及發展輔助,53200011103,0,0,1085951,0,0,1085951,0,0,0,0,0,1085951
2001,111,,,,,退休撫卹給付支出,76200010000,13281856,0,5598516,0,0,18880372,0,0,0,0,0,18880372
2001,111,,,10,,學校教職員暨社教機構聘任人員退休撫卹給付,76200012100,13281856,0,5598516,0,0,18880372,0,0,0,0,0,18880372
2001,112,11,,,,教育部主管,00200000000,,,,,,,,,,,,
2001,112,,1,,,教育部,00200010000,13693823,4023911,105720066,0,466292,123904092,98470,9232143,5746660,0,15077273,138981365
2001,112,,,,,教育支出,51200010000,758019,4023911,98141485,0,466292,103389707,98470,8974817,5746660,0,14819947,118209654
2001,112,,,1,,一般行政,51200010100,726768,229718,252247,0,0,1208733,1000,21191,1200,0,23391,1232124
2001,112,,,2,,高等教育,51200010200,0,1123223,88364992,0,0,89488215,41428,3914721,4772979,0,8729128,98217343
2001,112,,,,1,高等教育行政及督導,51200010201,0,584710,12070089,0,0,12654799,16664,2320416,955221,0,3292301,15947100
2001,112,,,,2,技術職業教育行政及督導,51200010202,0,480243,6385991,0,0,6866234,24464,1594305,655111,0,2273880,9140114
2001,112,,,,3,國立大學校院教學與研究輔助,51200010203,0,0,47589805,0,0,47589805,0,0,0,0,0,47589805
2001,112,,,,4,私立學校教學獎助,51200010204,0,58270,22319107,0,0,22377377,300,0,3162647,0,3162947,25540324
2001,112,,,3,,中等教育,51200010300,0,509639,956472,0,0,1466111,13484,18139,76272,0,107895,1574006
2001,112,,,,1,師資培育與藝術教育行政及督導,51200010301,0,509639,956472,0,0,1466111,13484,18139,76272,0,107895,1574006
2001,112,,,4,,終身教育,51200010500,31251,525193,1439741,0,0,1996185,4353,302990,340053,0,647396,2643581
2001,112,,,,1,終身教育行政及督導,51200010501,0,458453,1435303,0,0,1893756,4353,301696,340053,0,646102,2539858
2001,112,,,,2,國立臺灣藝術教育館行政及推展,51200010507,31251,66740,4438,0,0,102429,0,1294,0,0,1294,103723
2001,112,,,5,,學務與輔導,51200010700,0,265779,1762381,0,0,2028160,17663,78428,80650,0,176741,2204901
2001,112,,,,1,學生事務與特殊教育行政及督導,51200010701,0,265779,1762381,0,0,2028160,17663,78428,80650,0,176741,2204901
2001,112,,,6,,各項教育推展,51200010900,0,1370359,5365652,0,0,6736011,20542,313261,475506,0,809309,7545320
2001,112,,,,1,資訊與科技教育行政及督導,51200010904,0,1218203,2749865,0,0,3968068,16565,311831,466956,0,795352,4763420
2001,112,,,,2,國際及兩岸教育交流,51200010908,0,152156,2615787,0,0,2767943,3977,1430,8550,0,13957,2781900
2001,112,,,7,,非營業特種基金,51200018100,0,0,0,0,0,0,0,4324827,0,0,4324827,4324827
2001,112,,,,1,國立大學校院校務及附設醫院基金,51200018110,0,0,0,0,0,0,0,4324827,0,0,4324827,4324827
2001,112,,,8,,一般建築及設備,51200019000,0,0,0,0,0,0,0,1260,0,0,1260,1260
2001,112,,,,1,交通及運輸設備,51200019011,0,0,0,0,0,0,0,1260,0,0,1260,1260
2001,112,,,9,,第一預備金,51200019800,0,0,0,0,466292,466292,0,0,0,0,0,466292
2001,112,,,,,文化支出,53200010000,0,0,1137957,0,0,1137957,0,257326,0,0,257326,1395283
2001,112,,,10,,加強文化與育樂活動,53200011100,0,0,1137957,0,0,1137957,0,257326,0,0,257326,1395283
2001,112,,,,1,國立社教機構創新與發展,53200011101,0,0,52006,0,0,52006,0,257326,0,0,257326,309332
2001,112,,,,2,教育部所屬機構維持及發展輔助,53200011103,0,0,1085951,0,0,1085951,0,0,0,0,0,1085951
2001,112,,,,,退休撫卹給付支出,76200010000,12935804,0,6440624,0,0,19376428,0,0,0,0,0,19376428
2001,112,,,11,,學校教職員暨社教機構聘任人員退休撫卹給付,76200012100,12935804,0,6440624,0,0,19376428,0,0,0,0,0,19376428
2001,105,11,,,,教育部主管,00200000000,14467389,2501104,95253570,0,466292,112688355,31058,9177904,5606236,0,14815198,127503553
2001,105,,1,,,教育部,00200010000,14467389,2501104,95253570,0,466292,112688355,31058,9177904,5606236,0,14815198,127503553
2001,105,,,,,教育支出,51200010000,623684,2490574,83849054,0,466292,87429604,31058,8862077,5313238,0,14206373,101635977
2001,105,,,1,,一般行政,51200010100,594378,219620,38099,0,0,852097,4472,6388,1700,0,12560,864657
2001,105,,,2,,高等教育,51200010200,0,536895,77916470,0,0,78453365,426,2966419,4906340,0,7873185,86326550
2001,105,,,,1,高等教育行政及督導,51200010201,0,203717,7702202,0,0,7905919,426,1975884,334818,0,2311128,10217047
2001,105,,,,2,技術職業教育行政及督導,51200010202,0,279383,4186266,0,0,4465649,0,990535,1298136,0,2288671,6754320
2001,105,,,,3,國立大學校院教學與研究輔助,51200010203,0,0,42391310,0,0,42391310,0,0,0,0,0,42391310
2001,105,,,,4,私立學校教學獎助,51200010204,0,53795,23636692,0,0,23690487,0,0,3273386,0,3273386,26963873
2001,105,,,3,,中等教育,51200010300,0,457366,479126,0,0,936492,11950,20230,38780,0,70960,1007452
2001,105,,,,1,師資培育與藝術教育行政及督導,51200010301,0,457366,479126,0,0,936492,11950,20230,38780,0,70960,1007452
2001,105,,,4,,終身教育,51200010500,29306,204960,681818,0,0,916084,3300,77067,38795,0,119162,1035246
2001,105,,,,1,終身教育行政及督導,51200010501,0,162875,678732,0,0,841607,3300,76104,38795,0,118199,959806
2001,105,,,,2,國立臺灣藝術教育館行政及推展,51200010507,29306,42085,3086,0,0,74477,0,963,0,0,963,75440
2001,105,,,5,,訓育與輔導,51200010700,0,247419,1806142,0,0,2053561,9650,66435,88800,0,164885,2218446
2001,105,,,,1,學生事務與特殊教育行政及督導,51200010701,0,247419,1806142,0,0,2053561,9650,66435,88800,0,164885,2218446
2001,105,,,6,,各項教育推展,51200010900,0,824314,2927399,0,0,3751713,1260,196586,238823,0,436669,4188382
2001,105,,,,1,資訊與科技教育行政及督導,51200010904,0,668556,1338083,0,0,2006639,0,196586,237523,0,434109,2440748
2001,105,,,,2,國際及兩岸教育交流,51200010908,0,155758,1589316,0,0,1745074,1260,0,1300,0,2560,1747634
2001,105,,,7,,非營業特種基金,51200018100,0,0,0,0,0,0,0,5528952,0,0,5528952,5528952
2001,105,,,,1,國立大學校院校務及附設醫院基金,51200018110,0,0,0,0,0,0,0,5528952,0,0,5528952,5528952
2001,105,,,9,,第一預備金,51200019800,0,0,0,0,466292,466292,0,0,0,0,0,466292
2001,105,,,,,文化支出,53200010000,0,10530,1317263,0,0,1327793,0,315827,292998,0,608825,1936618
2001,105,,,10,,加強文化與育樂活動,53200011100,0,10530,1317263,0,0,1327793,0,313502,292998,0,606500,1934293
2001,105,,,,1,充實國立社教機構及公立圖書館功能,53200011101,0,10530,161716,0,0,172246,0,313502,292998,0,606500,778746
2001,105,,,,2,國立社教館所維持及發展輔助,53200011103,0,0,1155547,0,0,1155547,0,0,0,0,0,1155547
2001,105,,,11,,非營業特種基金,53200018100,0,0,0,0,0,0,0,2325,0,0,2325,2325
2001,105,,,,1,國立社教機構作業基金,53200018110,0,0,0,0,0,0,0,2325,0,0,2325,2325
2001,105,,,,,退休撫卹給付支出,75200010000,13843705,0,10087253,0,0,23930958,0,0,0,0,0,23930958
2001,105,,,12,,學校教職員暨社教機構聘任人員退休撫卹給付,75200012100,13843705,0,10087253,0,0,23930958,0,0,0,0,0,23930958
2001,106,11,,,,教育部主管,00200000000,16579396,2653647,95323278,0,466292,115022613,37912,10846824,8263156,0,19147892,134170505
2001,106,,1,,,教育部,00200010000,16579396,2653647,95323278,0,466292,115022613,37912,10846824,8263156,0,19147892,134170505
2001,106,,,,,教育支出,51200010000,596228,2653647,88104659,0,466292,91820826,37912,10350697,8145217,0,18533826,110354652
2001,106,,,1,,一般行政,51200010100,567552,239506,133049,0,0,940107,7904,52955,1300,0,62159,1002266
2001,106,,,2,,高等教育,51200010200,0,597032,81760486,0,0,82357518,5426,3112724,7645465,0,10763615,93121133
2001,106,,,,1,高等教育行政及督導,51200010201,0,203835,9365691,0,0,9569526,426,2030250,506838,0,2537514,12107040
2001,106,,,,2,技術職業教育行政及督導,51200010202,0,332342,5083499,0,0,5415841,5000,1082474,1136018,0,2223492,7639333
2001,106,,,,3,國立大學校院教學與研究輔助,51200010203,0,0,42350295,0,0,42350295,0,0,0,0,0,42350295
2001,106,,,,4,私立學校教學獎助,51200010204,0,60855,24961001,0,0,25021856,0,0,6002609,0,6002609,31024465
2001,106,,,3,,中等教育,51200010300,0,559366,686926,0,0,1246292,12950,21730,47280,0,81960,1328252
2001,106,,,,1,師資培育與藝術教育行政及督導,51200010301,0,559366,686926,0,0,1246292,12950,21730,47280,0,81960,1328252
2001,106,,,4,,終身教育,51200010500,28676,246100,1042474,0,0,1317250,400,131526,123881,0,255807,1573057
2001,106,,,,1,終身教育行政及督導,51200010501,0,200729,1039385,0,0,1240114,400,130411,123881,0,254692,1494806
2001,106,,,,2,國立臺灣藝術教育館行政及推展,51200010507,28676,45371,3089,0,0,77136,0,1115,0,0,1115,78251
2001,106,,,5,,學務與輔導,51200010700,0,249319,1588721,0,0,1838040,8650,62535,91500,0,162685,2000725
2001,106,,,,1,學生事務與特殊教育行政及督導,51200010701,0,249319,1588721,0,0,1838040,8650,62535,91500,0,162685,2000725
2001,106,,,6,,各項教育推展,51200010900,0,762324,2893003,0,0,3655327,2582,178023,235791,0,416396,4071723
2001,106,,,,1,資訊與科技教育行政及督導,51200010904,0,628060,1451159,0,0,2079219,0,170023,234491,0,404514,2483733
2001,106,,,,2,國際及兩岸教育交流,51200010908,0,134264,1441844,0,0,1576108,2582,8000,1300,0,11882,1587990
2001,106,,,7,,非營業特種基金,51200018100,0,0,0,0,0,0,0,6791204,0,0,6791204,6791204
2001,106,,,,1,國立大學校院校務及附設醫院基金,51200018110,0,0,0,0,0,0,0,4291204,0,0,4291204,4291204
2001,106,,,,2,大專校院轉型及退場基金,51200018120,0,0,0,0,0,0,0,2500000,0,0,2500000,2500000
2001,106,,,8,,第一預備金,51200019800,0,0,0,0,466292,466292,0,0,0,0,0,466292
2001,106,,,,,文化支出,53200010000,0,0,1253244,0,0,1253244,0,496127,117939,0,614066,1867310
2001,106,,,9,,加強文化與育樂活動,53200011100,0,0,1253244,0,0,1253244,0,490261,117939,0,608200,1861444
2001,106,,,,1,創新國立社教機構前瞻發展,53200011101,0,0,101238,0,0,101238,0,490261,117939,0,608200,709438
2001,106,,,,2,國立社教館所維持及發展輔助,53200011103,0,0,1152006,0,0,1152006,0,0,0,0,0,1152006
2001,106,,,10,,非營業特種基金,53200018100,0,0,0,0,0,0,0,5866,0,0,5866,5866
2001,106,,,,1,國立社教機構作業基金,53200018110,0,0,0,0,0,0,0,5866,0,0,5866,5866
2001,106,,,,,退休撫卹給付支出,75200010000,15983168,0,5965375,0,0,21948543,0,0,0,0,0,21948543
2001,106,,,11,,學校教職員暨社教機構聘任人員退休撫卹給付,75200012100,15983168,0,5965375,0,0,21948543,0,0,0,0,0,21948543
2001,107,11,,,,教育部主管,00200000000,15807360,2570306,100711858,0,466292,119555816,45889,7920329,5948800,0,13915018,133470834
2001,107,,1,,,教育部,00200010000,15807360,2570306,100711858,0,466292,119555816,45889,7920329,5948800,0,13915018,133470834
2001,107,,,,,教育支出,51200010000,596533,2570306,93158766,0,466292,96791897,45889,7812465,5929608,0,13787962,110579859
2001,107,,,1,,一般行政,51200010100,567552,220184,233098,0,0,1020834,6308,5588,1300,0,13196,1034030
2001,107,,,2,,高等教育,51200010200,0,622090,86058220,0,0,86680310,14674,2102463,5395475,0,7512612,94192922
2001,107,,,,1,高等教育行政及督導,51200010201,0,248550,11680285,0,0,11928835,5674,1681690,801542,0,2488906,14417741
2001,107,,,,2,技術職業教育行政及督導,51200010202,0,311124,7245936,0,0,7557060,9000,420773,683361,0,1113134,8670194
2001,107,,,,3,國立大學校院教學與研究輔助,51200010203,0,0,44702055,0,0,44702055,0,0,0,0,0,44702055
2001,107,,,,4,私立學校教學獎助,51200010204,0,62416,22429944,0,0,22492360,0,0,3910572,0,3910572,26402932
2001,107,,,3,,中等教育,51200010300,0,446600,849282,0,0,1295882,10190,25380,79903,0,115473,1411355
2001,107,,,,1,師資培育與藝術教育行政及督導,51200010301,0,446600,849282,0,0,1295882,10190,25380,79903,0,115473,1411355
2001,107,,,4,,終身教育,51200010500,28981,259438,1146326,0,0,1434745,470,300753,176871,0,478094,1912839
2001,107,,,,1,終身教育行政及督導,51200010501,0,211131,1143303,0,0,1354434,470,289823,176871,0,467164,1821598
2001,107,,,,2,國立臺灣藝術教育館行政及推展,51200010507,28981,48307,3023,0,0,80311,0,10930,0,0,10930,91241
2001,107,,,5,,學務與輔導,51200010700,0,262873,1578276,0,0,1841149,10621,59598,101407,0,171626,2012775
2001,107,,,,1,學生事務與特殊教育行政及督導,51200010701,0,262873,1578276,0,0,1841149,10621,59598,101407,0,171626,2012775
2001,107,,,6,,各項教育推展,51200010900,0,759121,3293564,0,0,4052685,3626,148157,174652,0,326435,4379120
2001,107,,,,1,資訊與科技教育行政及督導,51200010904,0,618235,1453160,0,0,2071395,654,145610,174252,0,320516,2391911
2001,107,,,,2,國際及兩岸教育交流,51200010908,0,140886,1840404,0,0,1981290,2972,2547,400,0,5919,1987209
2001,107,,,7,,非營業特種基金,51200018100,0,0,0,0,0,0,0,5170526,0,0,5170526,5170526
2001,107,,,,1,國立大學校院校務及附設醫院基金,51200018110,0,0,0,0,0,0,0,4270526,0,0,4270526,4270526
2001,107,,,,2,大專校院轉型及退場基金,51200018120,0,0,0,0,0,0,0,900000,0,0,900000,900000
2001,107,,,8,,第一預備金,51200019800,0,0,0,0,466292,466292,0,0,0,0,0,466292
2001,107,,,,,文化支出,53200010000,0,0,1209201,0,0,1209201,0,107864,19192,0,127056,1336257
2001,107,,,9,,加強文化與育樂活動,53200011100,0,0,1209201,0,0,1209201,0,104553,19192,0,123745,1332946
2001,107,,,,1,國立社教機構創新與發展,53200011101,0,0,36250,0,0,36250,0,104553,19192,0,123745,159995
2001,107,,,,2,國立社教館所維持及發展輔助,53200011103,0,0,1172951,0,0,1172951,0,0,0,0,0,1172951
2001,107,,,10,,非營業特種基金,53200018100,0,0,0,0,0,0,0,3311,0,0,3311,3311
2001,107,,,,1,國立社教機構作業基金,53200018110,0,0,0,0,0,0,0,3311,0,0,3311,3311
2001,107,,,,,退休撫卹給付支出,75200010000,15210827,0,6343891,0,0,21554718,0,0,0,0,0,21554718
2001,107,,,11,,學校教職員暨社教機構聘任人員退休撫卹給付,75200012100,15210827,0,6343891,0,0,21554718,0,0,0,0,0,21554718
2001,108,11,,,,教育部主管,00200000000,13240098,2665503,99649989,0,466292,116021882,71882,8112344,5630411,0,13814637,129836519
2001,108,,1,,,教育部,00200010000,13240098,2665503,99649989,0,466292,116021882,71882,8112344,5630411,0,13814637,129836519
2001,108,,,,,教育支出,51200010000,642994,2665503,94706342,0,466292,98481131,71882,7987186,5582983,0,13642051,112123182
2001,108,,,1,,一般行政,51200010100,613042,248787,166687,0,0,1028516,6780,40684,1448,0,48912,1077428
2001,108,,,2,,高等教育,51200010200,0,741575,87321599,0,0,88063174,33426,2830672,4997216,0,7861314,95924488
2001,108,,,,1,高等教育行政及督導,51200010201,0,314024,12101034,0,0,12415058,9926,2094300,930285,0,3034511,15449569
2001,108,,,,2,技術職業教育行政及督導,51200010202,0,364293,6868693,0,0,7232986,23500,736372,736254,0,1496126,8729112
2001,108,,,,3,國立大學校院教學與研究輔助,51200010203,0,0,45411302,0,0,45411302,0,0,0,0,0,45411302
2001,108,,,,4,私立學校教學獎助,51200010204,0,63258,22940570,0,0,23003828,0,0,3330677,0,3330677,26334505
2001,108,,,3,,中等教育,51200010300,0,474936,805990,0,0,1280926,12370,8853,70058,0,91281,1372207
2001,108,,,,1,師資培育與藝術教育行政及督導,51200010301,0,474936,805990,0,0,1280926,12370,8853,70058,0,91281,1372207
2001,108,,,4,,終身教育,51200010500,29952,250751,1130821,0,0,1411524,200,245721,239720,0,485641,1897165
2001,108,,,,1,終身教育行政及督導,51200010501,0,204870,1127783,0,0,1332653,200,208549,239720,0,448469,1781122
2001,108,,,,2,國立臺灣藝術教育館行政及推展,51200010507,29952,45881,3038,0,0,78871,0,37172,0,0,37172,116043
2001,108,,,5,,學務與輔導,51200010700,0,222956,1617040,0,0,1839996,10721,57255,101407,0,169383,2009379
2001,108,,,,1,學生事務與特殊教育行政及督導,51200010701,0,222956,1617040,0,0,1839996,10721,57255,101407,0,169383,2009379
2001,108,,,6,,各項教育推展,51200010900,0,726498,3664205,0,0,4390703,8385,143987,173134,0,325506,4716209
2001,108,,,,1,資訊與科技教育行政及督導,51200010904,0,588126,1426478,0,0,2014604,4895,143227,172734,0,320856,2335460
2001,108,,,,2,國際及兩岸教育交流,51200010908,0,138372,2237727,0,0,2376099,3490,760,400,0,4650,2380749
2001,108,,,7,,非營業特種基金,51200018100,0,0,0,0,0,0,0,4657392,0,0,4657392,4657392
2001,108,,,,1,國立大學校院校務及附設醫院基金,51200018110,0,0,0,0,0,0,0,3897392,0,0,3897392,3897392
2001,108,,,,2,大專校院轉型及退場基金,51200018120,0,0,0,0,0,0,0,760000,0,0,760000,760000
2001,108,,,8,,一般建築及設備,51200019000,0,0,0,0,0,0,0,2622,0,0,2622,2622
2001,108,,,,1,交通及運輸設備,51200019011,0,0,0,0,0,0,0,2622,0,0,2622,2622
2001,108,,,9,,第一預備金,51200019800,0,0,0,0,466292,466292,0,0,0,0,0,466292
2001,108,,,,,文化支出,53200010000,0,0,1225867,0,0,1225867,0,125158,47428,0,172586,1398453
2001,108,,,10,,加強文化與育樂活動,53200011100,0,0,1225867,0,0,1225867,0,125158,47428,0,172586,1398453
2001,108,,,,1,國立社教機構創新與發展,53200011101,0,0,49910,0,0,49910,0,125158,47428,0,172586,222496
2001,108,,,,2,國立社教館所維持及發展輔助,53200011103,0,0,1175957,0,0,1175957,0,0,0,0,0,1175957
2001,108,,,,,退休撫卹給付支出,75200010000,12597104,0,3717780,0,0,16314884,0,0,0,0,0,16314884
2001,108,,,12,,學校教職員暨社教機構聘任人員退休撫卹給付,75200012100,12597104,0,3717780,0,0,16314884,0,0,0,0,0,16314884
2001,109,11,,,,教育部主管,00200000000,,,,,,,,,,,,
2001,109,,1,,,教育部,00200010000,13013927,2889001,101629375,0,466292,117998595,97054,7651862,6076162,0,13825078,131823673
2001,109,,,,,教育支出,51200010000,639038,2889001,95056865,0,466292,99051196,97054,7533242,6035211,0,13665507,112716703
2001,109,,,1,,一般行政,51200010100,609294,244146,198512,0,0,1051952,1000,13745,724,0,15469,1067421
2001,109,,,2,,高等教育,51200010200,0,756261,87705187,0,0,88461448,26280,3305425,5017502,0,8349207,96810655
2001,109,,,,1,高等教育行政及督導,51200010201,0,313724,12428167,0,0,12741891,11280,2439053,1301737,0,3752070,16493961
2001,109,,,,2,技術職業教育行政及督導,51200010202,0,379999,6858147,0,0,7238146,15000,866372,673524,0,1554896,8793042
2001,109,,,,3,國立大學校院教學與研究輔助,51200010203,0,0,45839733,0,0,45839733,0,0,0,0,0,45839733
2001,109,,,,4,私立學校教學獎助,51200010204,0,62538,22579140,0,0,22641678,0,0,3042241,0,3042241,25683919
2001,109,,,3,,中等教育,51200010300,0,569763,827316,0,0,1397079,22914,20800,70620,0,114334,1511413
2001,109,,,,1,師資培育與藝術教育行政及督導,51200010301,0,569763,827316,0,0,1397079,22914,20800,70620,0,114334,1511413
2001,109,,,4,,終身教育,51200010500,29744,355322,1254024,0,0,1639090,29870,150230,731599,0,911699,2550789
2001,109,,,,1,終身教育行政及督導,51200010501,0,300686,1250986,0,0,1551672,29870,149680,731599,0,911149,2462821
2001,109,,,,2,國立臺灣藝術教育館行政及推展,51200010507,29744,54636,3038,0,0,87418,0,550,0,0,550,87968
2001,109,,,5,,學務與輔導,51200010700,0,275090,1513948,0,0,1789038,12600,53285,57997,0,123882,1912920
2001,109,,,,1,學生事務與特殊教育行政及督導,51200010701,0,275090,1513948,0,0,1789038,12600,53285,57997,0,123882,1912920
2001,109,,,6,,各項教育推展,51200010900,0,688419,3557878,0,0,4246297,4390,112495,156769,0,273654,4519951
2001,109,,,,1,資訊與科技教育行政及督導,51200010904,0,567768,1375981,0,0,1943749,900,111895,156369,0,269164,2212913
2001,109,,,,2,國際及兩岸教育交流,51200010908,0,120651,2181897,0,0,2302548,3490,600,400,0,4490,2307038
2001,109,,,7,,非營業特種基金,51200018100,0,0,0,0,0,0,0,3877262,0,0,3877262,3877262
2001,109,,,,1,國立大學校院校務及附設醫院基金,51200018110,0,0,0,0,0,0,0,3877262,0,0,3877262,3877262
2001,109,,,9,,第一預備金,51200019800,0,0,0,0,466292,466292,0,0,0,0,0,466292
2001,109,,,,,文化支出,53200010000,0,0,1206693,0,0,1206693,0,118620,40951,0,159571,1366264
2001,109,,,10,,加強文化與育樂活動,53200011100,0,0,1206693,0,0,1206693,0,118620,40951,0,159571,1366264
2001,109,,,,1,國立社教機構創新與發展,53200011101,0,0,30736,0,0,30736,0,118620,40951,0,159571,190307
2001,109,,,,2,教育部所屬機構維持及發展輔助,53200011103,0,0,1175957,0,0,1175957,0,0,0,0,0,1175957
2001,109,,,,,退休撫卹給付支出,76200010000,12374889,0,5365817,0,0,17740706,0,0,0,0,0,17740706
2001,109,,,11,,學校教職員暨社教機構聘任人員退休撫卹給付,76200012100,12374889,0,5365817,0,0,17740706,0,0,0,0,0,17740706
2001,110,11,,,,教育部主管,00200000000,,,,,,,,,,,,
2001,110,,1,,,教育部,00200010000,14512922,2871203,100770055,0,466292,118620472,119261,8276129,5922396,0,14317786,132938258
2001,110,,,,,教育支出,51200010000,708399,2871203,94398374,0,466292,98444268,119261,8013668,5866393,0,13999322,112443590
2001,110,,,1,,一般行政,51200010100,676547,244002,203688,0,0,1124237,1000,19427,1301,0,21728,1145965
2001,110,,,2,,高等教育,51200010200,0,737154,87065837,0,0,87802991,50550,3617695,4912333,0,8580578,96383569
2001,110,,,,1,高等教育行政及督導,51200010201,0,319662,12335753,0,0,12655415,14280,2345275,1301737,0,3661292,16316707
2001,110,,,,2,技術職業教育行政及督導,51200010202,0,355903,6585135,0,0,6941038,36270,1272420,573524,0,1882214,8823252
2001,110,,,,3,國立大學校院教學與研究輔助,51200010203,0,0,45953051,0,0,45953051,0,0,0,0,0,45953051
2001,110,,,,4,私立學校教學獎助,51200010204,0,61589,22191898,0,0,22253487,0,0,3037072,0,3037072,25290559
2001,110,,,3,,中等教育,51200010300,0,579281,769267,0,0,1348548,22384,21993,84720,0,129097,1477645
2001,110,,,,1,師資培育與藝術教育行政及督導,51200010301,0,579281,769267,0,0,1348548,22384,21993,84720,0,129097,1477645
2001,110,,,4,,終身教育,51200010500,31852,350159,1318225,0,0,1700236,19263,324875,671663,0,1015801,2716037
2001,110,,,,1,終身教育行政及督導,51200010501,0,295898,1315187,0,0,1611085,19263,318865,671663,0,1009791,2620876
2001,110,,,,2,國立臺灣藝術教育館行政及推展,51200010507,31852,54261,3038,0,0,89151,0,6010,0,0,6010,95161
2001,110,,,5,,學務與輔導,51200010700,0,276913,1587506,0,0,1864419,17174,46040,46650,0,109864,1974283
2001,110,,,,1,學生事務與特殊教育行政及督導,51200010701,0,276913,1587506,0,0,1864419,17174,46040,46650,0,109864,1974283
2001,110,,,6,,各項教育推展,51200010900,0,683694,3453851,0,0,4137545,8890,125722,149726,0,284338,4421883
2001,110,,,,1,資訊與科技教育行政及督導,51200010904,0,552005,1256725,0,0,1808730,400,125158,149326,0,274884,2083614
2001,110,,,,2,國際及兩岸教育交流,51200010908,0,131689,2197126,0,0,2328815,8490,564,400,0,9454,2338269
2001,110,,,7,,非營業特種基金,51200018100,0,0,0,0,0,0,0,3857916,0,0,3857916,3857916
2001,110,,,,1,國立大學校院校務及附設醫院基金,51200018110,0,0,0,0,0,0,0,3857916,0,0,3857916,3857916
2001,110,,,8,,第一預備金,51200019800,0,0,0,0,466292,466292,0,0,0,0,0,466292
2001,110,,,,,文化支出,53200010000,0,0,1094429,0,0,1094429,0,262461,56003,0,318464,1412893
2001,110,,,9,,加強文化與育樂活動,53200011100,0,0,1094429,0,0,1094429,0,262461,56003,0,318464,1412893
2001,110,,,,1,國立社教機構創新與發展,53200011101,0,0,36068,0,0,36068,0,262461,56003,0,318464,354532
2001,110,,,,2,教育部所屬機構維持及發展輔助,53200011103,0,0,1058361,0,0,1058361,0,0,0,0,0,1058361
2001,110,,,,,退休撫卹給付支出,76200010000,13804523,0,5277252,0,0,19081775,0,0,0,0,0,19081775
2001,110,,,10,,學校教職員暨社教機構聘任人員退休撫卹給付,76200012100,13804523,0,5277252,0,0,19081775,0,0,0,0,0,19081775
2001,111,11,,,,教育部主管,00200000000,,,,,,,,,,,,
2001,111,,1,,,教育部,00200010000,14018950,3283117,104273249,0,466292,122041608,91253,7388582,7025213,0,14505048,136546656
2001,111,,,,,教育支出,51200010000,737094,3283117,97540924,0,466292,102027427,91253,7152329,7022542,0,14266124,116293551
2001,111,,,1,,一般行政,51200010100,706547,230431,203411,0,0,1140389,1000,27440,1500,0,29940,1170329
2001,111,,,2,,高等教育,51200010200,0,965207,89168977,0,0,90134184,39781,3396686,4644491,0,8080958,98215142
2001,111,,,,1,高等教育行政及督導,51200010201,0,468920,12397254,0,0,12866174,18744,2175278,902450,0,3096472,15962646
2001,111,,,,2,技術職業教育行政及督導,51200010202,0,436539,6588648,0,0,7025187,20737,1221408,617684,0,1859829,8885016
2001,111,,,,3,國立大學校院教學與研究輔助,51200010203,0,0,47430997,0,0,47430997,0,0,0,0,0,47430997
2001,111,,,,4,私立學校教學獎助,51200010204,0,59748,22752078,0,0,22811826,300,0,3124357,0,3124657,25936483
2001,111,,,3,,中等教育,51200010300,0,512910,937209,0,0,1450119,22384,19389,80720,0,122493,1572612
2001,111,,,,1,師資培育與藝術教育行政及督導,51200010301,0,512910,937209,0,0,1450119,22384,19389,80720,0,122493,1572612
2001,111,,,4,,終身教育,51200010500,30547,401042,1412832,0,0,1844421,1874,363888,456402,0,822164,2666585
2001,111,,,,1,終身教育行政及督導,51200010501,0,345476,1409794,0,0,1755270,1874,362878,456402,0,821154,2576424
2001,111,,,,2,國立臺灣藝術教育館行政及推展,51200010507,30547,55566,3038,0,0,89151,0,1010,0,0,1010,90161
2001,111,,,5,,學務與輔導,51200010700,0,258189,1703469,0,0,1961658,17124,43115,46650,0,106889,2068547
2001,111,,,,1,學生事務與特殊教育行政及督導,51200010701,0,258189,1703469,0,0,1961658,17124,43115,46650,0,106889,2068547
2001,111,,,6,,各項教育推展,51200010900,0,915338,4115026,0,0,5030364,9090,95839,1792779,0,1897708,6928072
2001,111,,,,1,資訊與科技教育行政及督導,51200010904,0,796802,1826039,0,0,2622841,600,93840,1792379,0,1886819,4509660
2001,111,,,,2,國際及兩岸教育交流,51200010908,0,118536,2288987,0,0,2407523,8490,1999,400,0,10889,2418412
2001,111,,,7,,非營業特種基金,51200018100,0,0,0,0,0,0,0,3205972,0,0,3205972,3205972
2001,111,,,,1,國立大學校院校務及附設醫院基金,51200018110,0,0,0,0,0,0,0,3205972,0,0,3205972,3205972
2001,111,,,8,,第一預備金,51200019800,0,0,0,0,466292,466292,0,0,0,0,0,466292
2001,111,,,,,文化支出,53200010000,0,0,1133809,0,0,1133809,0,236253,2671,0,238924,1372733
2001,111,,,9,,加強文化與育樂活動,53200011100,0,0,1133809,0,0,1133809,0,236253,2671,0,238924,1372733
2001,111,,,,1,國立社教機構創新與發展,53200011101,0,0,47858,0,0,47858,0,236253,2671,0,238924,286782
2001,111,,,,2,教育部所屬機構維持及發展輔助,53200011103,0,0,1085951,0,0,1085951,0,0,0,0,0,1085951
2001,111,,,,,退休撫卹給付支出,76200010000,13281856,0,5598516,0,0,18880372,0,0,0,0,0,18880372
2001,111,,,10,,學校教職員暨社教機構聘任人員退休撫卹給付,76200012100,13281856,0,5598516,0,0,18880372,0,0,0,0,0,18880372
2001,112,11,,,,教育部主管,00200000000,,,,,,,,,,,,
2001,112,,1,,,教育部,00200010000,13693823,4191679,106264252,0,466292,124616046,114522,9843035,5790295,0,15747852,140363898
2001,112,,,,,教育支出,51200010000,758019,4191679,98685671,0,466292,104101661,114522,9549136,5790295,0,15453953,119555614
2001,112,,,1,,一般行政,51200010100,726768,237293,252290,0,0,1216351,1000,22739,1200,0,24939,1241290
2001,112,,,2,,高等教育,51200010200,0,1179627,88781276,0,0,89960903,48249,4461992,4775559,0,9285800,99246703
2001,112,,,,1,高等教育行政及督導,51200010201,0,614832,12077040,0,0,12691872,19744,2679110,955621,0,3654475,16346347
2001,112,,,,2,技術職業教育行政及督導,51200010202,0,504508,6395274,0,0,6899782,28205,1782882,656111,0,2467198,9366980
2001,112,,,,3,國立大學校院教學與研究輔助,51200010203,0,0,47589805,0,0,47589805,0,0,0,0,0,47589805
2001,112,,,,4,私立學校教學獎助,51200010204,0,60287,22719157,0,0,22779444,300,0,3163827,0,3164127,25943571
2001,112,,,3,,中等教育,51200010300,0,539790,969817,0,0,1509607,13484,19389,80720,0,113593,1623200
2001,112,,,,1,師資培育與藝術教育行政及督導,51200010301,0,539790,969817,0,0,1509607,13484,19389,80720,0,113593,1623200
2001,112,,,4,,終身教育,51200010500,31251,550872,1470569,0,0,2052692,4568,304955,367122,0,676645,2729337
2001,112,,,,1,終身教育行政及督導,51200010501,0,484090,1466131,0,0,1950221,4568,303661,367122,0,675351,2625572
2001,112,,,,2,國立臺灣藝術教育館行政及推展,51200010507,31251,66782,4438,0,0,102471,0,1294,0,0,1294,103765
2001,112,,,5,,學務與輔導,51200010700,0,274396,1764299,0,0,2038695,17663,79115,80650,0,177428,2216123
2001,112,,,,1,學生事務與特殊教育行政及督導,51200010701,0,274396,1764299,0,0,2038695,17663,79115,80650,0,177428,2216123
2001,112,,,6,,各項教育推展,51200010900,0,1409701,5447420,0,0,6857121,29558,334859,485044,0,849461,7706582
2001,112,,,,1,資訊與科技教育行政及督導,51200010904,0,1252471,2826007,0,0,4078478,22968,333330,476494,0,832792,4911270
2001,112,,,,2,國際及兩岸教育交流,51200010908,0,157230,2621413,0,0,2778643,6590,1529,8550,0,16669,2795312
2001,112,,,7,,非營業特種基金,51200018100,0,0,0,0,0,0,0,4324827,0,0,4324827,4324827
2001,112,,,,1,國立大學校院校務及附設醫院基金,51200018110,0,0,0,0,0,0,0,4324827,0,0,4324827,4324827
2001,112,,,8,,一般建築及設備,51200019000,0,0,0,0,0,0,0,1260,0,0,1260,1260
2001,112,,,,1,交通及運輸設備,51200019011,0,0,0,0,0,0,0,1260,0,0,1260,1260
2001,112,,,9,,第一預備金,51200019800,0,0,0,0,466292,466292,0,0,0,0,0,466292
2001,112,,,,,文化支出,53200010000,0,0,1137957,0,0,1137957,0,293899,0,0,293899,1431856
2001,112,,,10,,加強文化與育樂活動,53200011100,0,0,1137957,0,0,1137957,0,293899,0,0,293899,1431856
2001,112,,,,1,國立社教機構創新與發展,53200011101,0,0,52006,0,0,52006,0,293899,0,0,293899,345905
2001,112,,,,2,教育部所屬機構維持及發展輔助,53200011103,0,0,1085951,0,0,1085951,0,0,0,0,0,1085951
2001,112,,,,,退休撫卹給付支出,76200010000,12935804,0,6440624,0,0,19376428,0,0,0,0,0,19376428
2001,112,,,11,,學校教職員暨社教機構聘任人員退休撫卹給付,76200012100,12935804,0,6440624,0,0,19376428,0,0,0,0,0,19376428
2001,113,11,,,,教育部主管,00200000000,,,,,,,,,,,,
2001,113,,1,,,教育部,00200010000,13796251,4328977,136758931,0,466292,155350451,106226,9795315,6063251,0,15964792,171315243
2001,113,,,,,教育支出,51200010000,757882,4328977,124033738,0,466292,129586889,106226,9561204,6063251,0,15730681,145317570
2001,113,,,1,,一般行政,51200010100,726768,242705,298775,0,0,1268248,1000,30298,1200,0,32498,1300746
2001,113,,,2,,高等教育,51200010200,0,1166617,113536251,0,0,114702868,47942,3953621,4824979,0,8826542,123529410
2001,113,,,,1,高等教育行政及督導,51200010201,0,653970,14033998,0,0,14687968,19078,2459587,1004500,0,3483165,18171133
2001,113,,,,2,技術職業教育行政及督導,51200010202,0,433407,7325592,0,0,7758999,28564,1494034,582208,0,2104806,9863805
2001,113,,,,3,國立大學校院教學與研究輔助,51200010203,0,0,50717026,0,0,50717026,0,0,0,0,0,50717026
2001,113,,,,4,私立學校教學獎助,51200010204,0,79240,41459635,0,0,41538875,300,0,3238271,0,3238571,44777446
2001,113,,,3,,中等教育,51200010300,0,525778,1054881,0,0,1580659,8915,23289,87641,0,119845,1700504
2001,113,,,,1,師資培育與藝術教育行政及督導,51200010301,0,525778,1054881,0,0,1580659,8915,23289,87641,0,119845,1700504
2001,113,,,4,,終身教育,51200010500,31114,586810,1578826,0,0,2196750,3353,397003,498004,0,898360,3095110
2001,113,,,,1,終身教育行政及督導,51200010501,0,519229,1574388,0,0,2093617,3353,385420,498004,0,886777,2980394
2001,113,,,,2,國立臺灣藝術教育館行政及推展,51200010507,31114,67581,4438,0,0,103133,0,11583,0,0,11583,114716
2001,113,,,5,,學務與輔導,51200010700,0,381405,1849279,0,0,2230684,17509,238559,141900,0,397968,2628652
2001,113,,,,1,學生事務與特殊教育行政及督導,51200010701,0,381405,1849279,0,0,2230684,17509,238559,141900,0,397968,2628652
2001,113,,,6,,各項教育推展,51200010900,0,1425662,5715726,0,0,7141388,27507,448642,509527,0,985676,8127064
2001,113,,,,1,資訊與科技教育行政及督導,51200010904,0,1255828,2966172,0,0,4222000,23530,447212,505627,0,976369,5198369
2001,113,,,,2,國際及兩岸教育交流,51200010908,0,169834,2749554,0,0,2919388,3977,1430,3900,0,9307,2928695
2001,113,,,7,,非營業特種基金,51200018100,0,0,0,0,0,0,0,4468652,0,0,4468652,4468652
2001,113,,,,1,國立大學校院校務及附設醫院基金,51200018110,0,0,0,0,0,0,0,4268652,0,0,4268652,4268652
2001,113,,,,2,私立高級中等以上學校退場基金,51200018120,0,0,0,0,0,0,0,200000,0,0,200000,200000
2001,113,,,8,,一般建築及設備,51200019000,0,0,0,0,0,0,0,1140,0,0,1140,1140
2001,113,,,,1,交通及運輸設備,51200019011,0,0,0,0,0,0,0,1140,0,0,1140,1140
2001,113,,,9,,第一預備金,51200019800,0,0,0,0,466292,466292,0,0,0,0,0,466292
2001,113,,,,,文化支出,53200010000,0,0,1139736,0,0,1139736,0,234111,0,0,234111,1373847
2001,113,,,10,,加強文化與育樂活動,53200011100,0,0,1139736,0,0,1139736,0,234111,0,0,234111,1373847
2001,113,,,,1,國立社教機構創新與發展,53200011101,0,0,25091,0,0,25091,0,234111,0,0,234111,259202
2001,113,,,,2,教育部所屬機構維持及發展輔助,53200011103,0,0,1114645,0,0,1114645,0,0,0,0,0,1114645
2001,113,,,,,退休撫卹給付支出,76200010000,13038369,0,11585457,0,0,24623826,0,0,0,0,0,24623826
2001,113,,,11,,學校教職員暨社教機構聘任人員退休撫卹給付,76200012100,13038369,0,11585457,0,0,24623826,0,0,0,0,0,24623826
